臺北市,松山區,莊敬里,2010,1132,878,19,2029,4467,45.42,25.34
臺北市,松山區,東榮里,3402,1735,1667,14,3416,6468,52.81,26.82
臺北市,松山區,三民里,2918,1662,1256,30,2948,5723,51.51,29.04
臺北市,松山區,新益里,1991,1034,957,13,2004,3881,51.64,26.64
臺北市,松山區,富錦里,2171,1183,988,18,2189,4281,51.13,27.63
臺北市,松山區,新東里,2049,1146,903,18,2067,4135,49.99,27.71
臺北市,松山區,富泰里,1883,1150,733,17,1900,3884,48.92,29.61
臺北市,松山區,介壽里,1790,942,848,15,1805,3540,50.99,26.61
臺北市,松山區,精忠里,1772,975,797,21,1793,3553,50.46,27.44
臺北市,松山區,東光里,3031,1729,1302,30,3061,6051,50.59,28.57
臺北市,松山區,龍田里,4242,2820,1422,57,4299,8377,51.32,33.66
臺北市,松山區,東昌里,1174,561,613,5,1179,2184,53.98,25.69
臺北市,松山區,東勢里,1769,876,893,18,1787,3518,50.8,24.9
臺北市,松山區,中華里,2635,1486,1149,31,2666,5140,51.87,28.91
臺北市,松山區,民有里,3790,1864,1926,24,3814,7351,51.88,25.36
臺北市,松山區,民福里,2831,1672,1159,24,2855,5381,53.06,31.07
臺北市,松山區,慈祐里,2741,1308,1433,22,2763,7162,38.58,18.26
臺北市,松山區,安平里,3315,1652,1663,34,3349,7230,46.32,22.85
臺北市,松山區,鵬程里,2266,1416,850,31,2297,4616,49.76,30.68
臺北市,松山區,自強里,3955,2977,978,67,4022,7730,52.03,38.51
臺北市,松山區,吉祥里,3369,1821,1548,27,3396,6959,48.8,26.17
臺北市,松山區,新聚里,3083,1562,1521,34,3117,6657,46.82,23.46
臺北市,松山區,復盛里,2631,1480,1151,27,2658,5286,50.28,28.0
臺北市,松山區,中正里,3458,1726,1732,34,3492,7611,45.88,22.68
臺北市,松山區,中崙里,1570,830,740,21,1591,3317,47.97,25.02
臺北市,松山區,美仁里,1410,680,730,12,1422,2882,49.34,23.59
臺北市,松山區,吉仁里,1481,757,724,9,1490,3234,46.07,23.41
臺北市,松山區,敦化里,2886,1470,1416,28,2914,5590,52.13,26.3
臺北市,松山區,復源里,1337,755,582,8,1345,2642,50.91,28.58
臺北市,松山區,復建里,1801,1001,800,22,1823,3714,49.08,26.95
臺北市,松山區,復勢里,2505,1230,1275,26,2531,5206,48.62,23.63
臺北市,松山區,福成里,1050,510,540,15,1065,2147,49.6,23.75
臺北市,松山區,松基里,1465,744,721,14,1479,3047,48.54,24.42
臺北市,信義區,西村里,2108,1481,627,20,2128,4958,42.92,29.87
臺北市,信義區,正和里,1964,1217,747,17,1981,3767,52.59,32.31
臺北市,信義區,興隆里,1005,616,389,14,1019,2224,45.82,27.7
臺北市,信義區,中興里,1290,725,565,15,1305,2903,44.95,24.97
臺北市,信義區,新仁里,1334,797,537,11,1345,2732,49.23,29.17
臺北市,信義區,興雅里,2173,1175,998,26,2199,4753,46.27,24.72
臺北市,信義區,敦厚里,1990,1089,901,12,2002,4357,45.95,24.99
臺北市,信義區,廣居里,3060,1751,1309,20,3080,6335,48.62,27.64
臺北市,信義區,安康里,3899,2137,1762,44,3943,8511,46.33,25.11
臺北市,信義區,六藝里,1422,716,706,13,1435,3102,46.26,23.08
臺北市,信義區,雅祥里,2009,1007,1002,29,2038,4266,47.77,23.61
臺北市,信義區,五常里,1480,814,666,7,1487,3106,47.88,26.21
臺北市,信義區,五全里,1948,897,1051,13,1961,4081,48.05,21.98
臺北市,信義區,永吉里,1413,573,840,9,1422,3370,42.2,17.0
臺北市,信義區,長春里,1565,772,793,15,1580,3629,43.54,21.27
臺北市,信義區,四育里,2321,1124,1197,29,2350,4754,49.43,23.64
臺北市,信義區,四維里,2122,1193,929,23,2145,4535,47.3,26.31
臺北市,信義區,永春里,1913,981,932,33,1946,4223,46.08,23.23
臺北市,信義區,富台里,1718,1093,625,28,1746,3723,46.9,29.36
臺北市,信義區,國業里,2828,1567,1261,19,2847,6147,46.32,25.49
臺北市,信義區,松隆里,875,472,403,7,882,1924,45.84,24.53
臺北市,信義區,松友里,2532,1396,1136,19,2551,5536,46.08,25.22
臺北市,信義區,松光里,1943,976,967,21,1964,4245,46.27,22.99
臺北市,信義區,中坡里,1872,996,876,16,1888,3791,49.8,26.27
臺北市,信義區,中行里,3061,1530,1531,26,3087,6724,45.91,22.75
臺北市,信義區,大道里,2469,1223,1246,20,2489,5177,48.08,23.62
臺北市,信義區,大仁里,1515,797,718,13,1528,3445,44.35,23.13
臺北市,信義區,景新里,2044,1231,813,18,2062,4324,47.69,28.47
臺北市,信義區,惠安里,2533,1523,1010,21,2554,5572,45.84,27.33
臺北市,信義區,三張里,3532,2110,1422,43,3575,7503,47.65,28.12
臺北市,信義區,三犁里,2010,1151,859,20,2030,4453,45.59,25.85
臺北市,信義區,六合里,2663,1654,1009,28,2691,5784,46.52,28.6
臺北市,信義區,泰和里,2736,1558,1178,20,2756,6519,42.28,23.9
臺北市,信義區,景聯里,1910,1077,833,20,1930,3961,48.73,27.19
臺北市,信義區,景勤里,1482,874,608,7,1489,3292,45.23,26.55
臺北市,信義區,雙和里,2938,1750,1188,17,2955,6033,48.98,29.01
臺北市,信義區,嘉興里,1328,729,599,9,1337,2713,49.28,26.87
臺北市,信義區,黎順里,1554,912,642,14,1568,3427,45.75,26.61
臺北市,信義區,黎平里,2915,1695,1220,33,2948,5973,49.36,28.38
臺北市,信義區,黎忠里,1994,1180,814,12,2006,4141,48.44,28.5
臺北市,信義區,黎安里,733,479,254,16,749,1734,43.19,27.62
臺北市,大安區,德安里,2293,1423,870,15,2308,4632,49.83,30.72
臺北市,大安區,仁慈里,2165,1135,1030,16,2181,4304,50.67,26.37
臺北市,大安區,和安里,2629,1511,1118,16,2645,5471,48.35,27.62
臺北市,大安區,民炤里,3219,1719,1500,31,3250,6608,49.18,26.01
臺北市,大安區,仁愛里,1914,1015,899,14,1928,4212,45.77,24.1
臺北市,大安區,義村里,2470,1627,843,9,2479,4707,52.67,34.57
臺北市,大安區,民輝里,2709,1459,1250,27,2736,5704,47.97,25.58
臺北市,大安區,昌隆里,1353,656,697,16,1369,2713,50.46,24.18
臺北市,大安區,誠安里,1667,870,797,18,1685,3427,49.17,25.39
臺北市,大安區,光武里,2841,1551,1290,32,2873,6211,46.26,24.97
臺北市,大安區,龍坡里,2345,1323,1022,26,2371,4608,51.45,28.71
臺北市,大安區,龍泉里,1910,1019,891,17,1927,4046,47.63,25.19
臺北市,大安區,古風里,1795,969,826,14,1809,3495,51.76,27.73
臺北市,大安區,古莊里,2890,1587,1303,25,2915,6074,47.99,26.13
臺北市,大安區,龍安里,2438,1295,1143,20,2458,6710,36.63,19.3
臺北市,大安區,錦安里,2354,1338,1016,17,2371,4806,49.33,27.84
臺北市,大安區,福住里,2371,1266,1105,24,2395,5061,47.32,25.01
臺北市,大安區,永康里,1432,804,628,9,1441,2977,48.4,27.01
臺北市,大安區,光明里,1466,827,639,19,1485,2987,49.72,27.69
臺北市,大安區,錦泰里,1491,916,575,20,1511,3004,50.3,30.49
臺北市,大安區,錦華里,2359,1358,1001,21,2380,4627,51.44,29.35
臺北市,大安區,龍圖里,2696,1581,1115,27,2723,5613,48.51,28.17
臺北市,大安區,新龍里,2891,1935,956,30,2921,5527,52.85,35.01
臺北市,大安區,龍陣里,1477,823,654,8,1485,2947,50.39,27.93
臺北市,大安區,龍雲里,1996,1123,873,18,2014,3937,51.16,28.52
臺北市,大安區,龍生里,2751,1607,1144,29,2780,5409,51.4,29.71
臺北市,大安區,住安里,1869,1105,764,23,1892,4245,44.57,26.03
臺北市,大安區,義安里,2070,1218,852,15,2085,4455,46.8,27.34
臺北市,大安區,通化里,2482,1225,1257,23,2505,5249,47.72,23.34
臺北市,大安區,通安里,2172,1181,991,37,2209,4590,48.13,25.73
臺北市,大安區,臨江里,1629,905,724,21,1650,3527,46.78,25.66
臺北市,大安區,法治里,1865,1167,698,20,1885,3732,50.51,31.27
臺北市,大安區,全安里,1781,1055,726,23,1804,3699,48.77,28.52
臺北市,大安區,群賢里,2401,1488,913,23,2424,4899,49.48,30.37
臺北市,大安區,群英里,3139,2260,879,23,3162,5848,54.07,38.65
臺北市,大安區,虎嘯里,1550,873,677,11,1561,3137,49.76,27.83
臺北市,大安區,臥龍里,870,524,346,13,883,1729,51.07,30.31
臺北市,大安區,龍淵里,3681,2038,1643,30,3711,7435,49.91,27.41
臺北市,大安區,龍門里,1847,1002,845,13,1860,3529,52.71,28.39
臺北市,大安區,大學里,3641,2054,1587,33,3674,6961,52.78,29.51
臺北市,大安區,芳和里,2333,1342,991,28,2361,4904,48.14,27.37
臺北市,大安區,黎元里,2097,1175,922,23,2120,4683,45.27,25.09
臺北市,大安區,黎孝里,3201,1814,1387,33,3234,6467,50.01,28.05
臺北市,大安區,黎和里,1875,1150,725,22,1897,3938,48.17,29.2
臺北市,大安區,建安里,1820,1026,794,12,1832,4048,45.26,25.35
臺北市,大安區,建倫里,2265,1240,1025,26,2291,5023,45.61,24.69
臺北市,大安區,敦安里,2353,1270,1083,18,2371,5100,46.49,24.9
臺北市,大安區,正聲里,1763,1020,743,18,1781,3818,46.65,26.72
臺北市,大安區,敦煌里,2338,1252,1086,25,2363,4922,48.01,25.44
臺北市,大安區,華聲里,1574,892,682,13,1587,3473,45.7,25.68
臺北市,大安區,車層里,2441,1295,1146,18,2459,5221,47.1,24.8
臺北市,大安區,光信里,3055,1719,1336,39,3094,6249,49.51,27.51
臺北市,大安區,學府里,965,598,367,15,980,2171,45.14,27.54
臺北市,中山區,正守里,1270,612,658,11,1281,2806,45.65,21.81
臺北市,中山區,正義里,1848,942,906,14,1862,4541,41.0,20.74
臺北市,中山區,正得里,1371,695,676,16,1387,3136,44.23,22.16
臺北市,中山區,民安里,1819,829,990,18,1837,3798,48.37,21.83
臺北市,中山區,康樂里,1002,543,459,12,1014,2307,43.95,23.54
臺北市,中山區,中山里,2501,1242,1259,17,2518,5902,42.66,21.04
臺北市,中山區,聚盛里,1456,767,689,14,1470,3728,39.43,20.57
臺北市,中山區,集英里,2713,1198,1515,25,2738,5936,46.13,20.18
臺北市,中山區,聚葉里,1487,685,802,11,1498,3471,43.16,19.73
臺北市,中山區,恆安里,1777,872,905,17,1794,4310,41.62,20.23
臺北市,中山區,晴光里,1943,1012,931,14,1957,4704,41.6,21.51
臺北市,中山區,圓山里,1556,716,840,8,1564,3587,43.6,19.96
臺北市,中山區,劍潭里,1554,1207,347,19,1573,3095,50.82,39.0
臺北市,中山區,大直里,3688,2088,1600,41,3729,7456,50.01,28.0
臺北市,中山區,成功里,2478,1251,1227,24,2502,5305,47.16,23.58
臺北市,中山區,永安里,3802,1993,1809,44,3846,7732,49.74,25.78
臺北市,中山區,大佳里,414,144,270,2,416,904,46.02,15.93
臺北市,中山區,新喜里,1950,875,1075,12,1962,4399,44.6,19.89
臺北市,中山區,新庄里,1991,902,1089,26,2017,4267,47.27,21.14
臺北市,中山區,新福里,2107,847,1260,18,2125,4414,48.14,19.19
臺北市,中山區,松江里,2563,1175,1388,24,2587,5384,48.05,21.82
臺北市,中山區,新生里,1858,822,1036,17,1875,4061,46.17,20.24
臺北市,中山區,中庄里,1946,847,1099,26,1972,4318,45.67,19.62
臺北市,中山區,行政里,2328,1141,1187,27,2355,6616,35.6,17.25
臺北市,中山區,行仁里,3069,1369,1700,29,3098,6794,45.6,20.15
臺北市,中山區,行孝里,1580,688,892,21,1601,3692,43.36,18.63
臺北市,中山區,下埤里,3082,1422,1660,25,3107,6421,48.39,22.15
臺北市,中山區,江寧里,2844,1437,1407,28,2872,5828,49.28,24.66
臺北市,中山區,江山里,3100,1438,1662,26,3126,6371,49.07,22.57
臺北市,中山區,中吉里,2262,945,1317,19,2281,4719,48.34,20.03
臺北市,中山區,中原里,2187,983,1204,13,2200,4380,50.23,22.44
臺北市,中山區,興亞里,2149,1004,1145,21,2170,4589,47.29,21.88
臺北市,中山區,中央里,1464,696,768,9,1473,3031,48.6,22.96
臺北市,中山區,朱馥里,2071,1053,1018,18,2089,4892,42.7,21.52
臺北市,中山區,龍洲里,2232,1540,692,26,2258,4278,52.78,36.0
臺北市,中山區,朱園里,1857,862,995,18,1875,3885,48.26,22.19
臺北市,中山區,埤頭里,1312,658,654,12,1324,2772,47.76,23.74
臺北市,中山區,朱崙里,1208,565,643,12,1220,2553,47.79,22.13
臺北市,中山區,力行里,2479,1137,1342,29,2508,5215,48.09,21.8
臺北市,中山區,復華里,1930,1084,846,28,1958,4000,48.95,27.1
臺北市,中山區,金泰里,2889,1571,1318,30,2919,6417,45.49,24.48
臺北市,中山區,北安里,1079,649,430,13,1092,2179,50.11,29.78
臺北市,中正區,水源里,1192,603,589,14,1206,2569,46.94,23.47
臺北市,中正區,富水里,893,595,298,7,900,2107,42.71,28.24
臺北市,中正區,文盛里,1116,597,519,4,1120,2181,51.35,27.37
臺北市,中正區,林興里,1884,1123,761,18,1902,4011,47.42,28.0
臺北市,中正區,河堤里,1944,1135,809,13,1957,3802,51.47,29.85
臺北市,中正區,頂東里,2686,1461,1225,22,2708,5155,52.53,28.34
臺北市,中正區,網溪里,2486,1363,1123,26,2512,4893,51.34,27.86
臺北市,中正區,板溪里,1302,732,570,11,1313,2775,47.32,26.38
臺北市,中正區,螢圃里,2361,1340,1021,26,2387,4773,50.01,28.07
臺北市,中正區,螢雪里,1761,1006,755,18,1779,3653,48.7,27.54
臺北市,中正區,永功里,2462,1276,1186,33,2495,5214,47.85,24.47
臺北市,中正區,永昌里,2183,1192,991,20,2203,4177,52.74,28.54
臺北市,中正區,龍興里,1331,695,636,11,1342,2906,46.18,23.92
臺北市,中正區,忠勤里,2327,1351,976,35,2362,5486,43.06,24.63
臺北市,中正區,廈安里,1583,820,763,18,1601,3475,46.07,23.6
臺北市,中正區,愛國里,1231,638,593,9,1240,2583,48.01,24.7
臺北市,中正區,南門里,1119,676,443,12,1131,2153,52.53,31.4
臺北市,中正區,龍光里,1355,780,575,12,1367,2662,51.35,29.3
臺北市,中正區,南福里,4410,2454,1956,35,4445,8918,49.84,27.52
臺北市,中正區,龍福里,2022,1105,917,24,2046,4216,48.53,26.21
臺北市,中正區,新營里,3276,1977,1299,25,3301,6851,48.18,28.86
臺北市,中正區,建國里,564,330,234,3,567,1240,45.73,26.61
臺北市,中正區,光復里,1403,728,675,11,1414,3153,44.85,23.09
臺北市,中正區,黎明里,1070,569,501,11,1081,2719,39.76,20.93
臺北市,中正區,梅花里,1283,636,647,15,1298,2626,49.43,24.22
臺北市,中正區,幸福里,1902,1055,847,25,1927,4871,39.56,21.66
臺北市,中正區,幸市里,1924,985,939,18,1942,3689,52.64,26.7
臺北市,中正區,東門里,1502,878,624,18,1520,3113,48.83,28.2
臺北市,中正區,文北里,2290,1234,1056,25,2315,4517,51.25,27.32
臺北市,中正區,文祥里,3069,1678,1391,33,3102,6282,49.38,26.71
臺北市,中正區,三愛里,3382,1794,1588,38,3420,6997,48.88,25.64
臺北市,大同區,玉泉里,1141,470,671,8,1149,2534,45.34,18.55
臺北市,大同區,建明里,1218,505,713,12,1230,2790,44.09,18.1
臺北市,大同區,建功里,1735,739,996,14,1749,3999,43.74,18.48
臺北市,大同區,建泰里,1424,568,856,25,1449,3039,47.68,18.69
臺北市,大同區,永樂里,2040,791,1249,12,2052,4399,46.65,17.98
臺北市,大同區,朝陽里,1795,771,1024,18,1813,3812,47.56,20.23
臺北市,大同區,星明里,2178,978,1200,18,2196,4940,44.45,19.8
臺北市,大同區,光能里,1949,823,1126,12,1961,4161,47.13,19.78
臺北市,大同區,大有里,1812,708,1104,17,1829,3943,46.39,17.96
臺北市,大同區,延平里,1586,684,902,16,1602,3592,44.6,19.04
臺北市,大同區,雙連里,3418,1426,1992,30,3448,7671,44.95,18.59
臺北市,大同區,南芳里,1534,622,912,18,1552,3376,45.97,18.42
臺北市,大同區,民權里,2486,1120,1366,16,2502,5223,47.9,21.44
臺北市,大同區,景星里,982,382,600,9,991,2231,44.42,17.12
臺北市,大同區,隆和里,1408,546,862,14,1422,2898,49.07,18.84
臺北市,大同區,蓬萊里,1949,833,1116,19,1968,4213,46.71,19.77
臺北市,大同區,國順里,999,356,643,9,1008,2305,43.73,15.44
臺北市,大同區,國慶里,1910,826,1084,7,1917,3894,49.23,21.21
臺北市,大同區,揚雅里,1434,552,882,5,1439,4063,35.42,13.59
臺北市,大同區,斯文里,1800,713,1087,23,1823,4057,44.93,17.57
臺北市,大同區,鄰江里,2597,1036,1561,15,2612,5537,47.17,18.71
臺北市,大同區,至聖里,3179,1335,1844,26,3205,6748,47.5,19.78
臺北市,大同區,老師里,2160,844,1316,11,2171,4953,43.83,17.04
臺北市,大同區,重慶里,2675,1262,1413,22,2697,5666,47.6,22.27
臺北市,大同區,保安里,1861,759,1102,14,1875,3771,49.72,20.13
臺北市,萬華區,福星里,1953,1052,901,25,1978,4638,42.65,22.68
臺北市,萬華區,萬壽里,1120,605,515,15,1135,2831,40.09,21.37
臺北市,萬華區,西門里,1340,733,607,13,1353,3187,42.45,23.0
臺北市,萬華區,新起里,2695,1332,1363,41,2736,5920,46.22,22.5
臺北市,萬華區,菜園里,2516,1145,1371,17,2533,5356,47.29,21.38
臺北市,萬華區,青山里,2253,1044,1209,19,2272,5124,44.34,20.37
臺北市,萬華區,富民里,1959,828,1131,31,1990,4299,46.29,19.26
臺北市,萬華區,福音里,1560,690,870,15,1575,3366,46.79,20.5
臺北市,萬華區,仁德里,2023,966,1057,15,2038,4094,49.78,23.6
臺北市,萬華區,富福里,1912,821,1091,22,1934,5354,36.12,15.33
臺北市,萬華區,頂碩里,2813,1239,1574,29,2842,6064,46.87,20.43
臺北市,萬華區,雙園里,1770,798,972,22,1792,3864,46.38,20.65
臺北市,萬華區,新忠里,1525,1147,378,13,1538,2993,51.39,38.32
臺北市,萬華區,新和里,3759,2711,1048,56,3815,7108,53.67,38.14
臺北市,萬華區,糖廍里,2194,974,1220,26,2220,4679,47.45,20.82
臺北市,萬華區,和平里,2481,956,1525,27,2508,5752,43.6,16.62
臺北市,萬華區,綠堤里,1510,765,745,18,1528,3698,41.32,20.69
臺北市,萬華區,華江里,3190,1528,1662,28,3218,7226,44.53,21.15
臺北市,萬華區,柳鄉里,1901,783,1118,17,1918,4403,43.56,17.78
臺北市,萬華區,日善里,1448,641,807,15,1463,3103,47.15,20.66
臺北市,萬華區,新安里,2215,1341,874,23,2238,5228,42.81,25.65
臺北市,萬華區,忠德里,1752,780,972,11,1763,3813,46.24,20.46
臺北市,萬華區,孝德里,1313,525,788,13,1326,2802,47.32,18.74
臺北市,萬華區,和德里,2294,988,1306,24,2318,5570,41.62,17.74
臺北市,萬華區,錦德里,2098,972,1126,20,2118,4714,44.93,20.62
臺北市,萬華區,全德里,1679,802,877,28,1707,3631,47.01,22.09
臺北市,萬華區,保德里,1335,646,689,12,1347,2752,48.95,23.47
臺北市,萬華區,銘德里,1769,797,972,17,1786,3985,44.82,20.0
臺北市,萬華區,榮德里,1485,656,829,18,1503,3075,48.88,21.33
臺北市,萬華區,壽德里,1944,925,1019,20,1964,4233,46.4,21.85
臺北市,萬華區,興德里,1740,786,954,18,1758,3911,44.95,20.1
臺北市,萬華區,華中里,2443,1095,1348,29,2472,5226,47.3,20.95
臺北市,萬華區,日祥里,2559,1624,935,25,2584,5167,50.01,31.43
臺北市,萬華區,忠貞里,1950,1320,630,30,1980,4179,47.38,31.59
臺北市,萬華區,凌霄里,1456,936,520,25,1481,3097,47.82,30.22
臺北市,萬華區,騰雲里,1339,837,502,13,1352,2636,51.29,31.75
臺北市,文山區,景行里,2885,1559,1326,29,2914,6344,45.93,24.57
臺北市,文山區,景東里,2816,1807,1009,24,2840,5987,47.44,30.18
臺北市,文山區,景美里,2054,1148,906,15,2069,4219,49.04,27.21
臺北市,文山區,景慶里,2635,1536,1099,22,2657,5431,48.92,28.28
臺北市,文山區,景仁里,2348,1415,933,21,2369,4675,50.67,30.27
臺北市,文山區,景華里,2364,1445,919,21,2385,4768,50.02,30.31
臺北市,文山區,萬有里,2328,1407,921,17,2345,4621,50.75,30.45
臺北市,文山區,萬祥里,1860,1045,815,24,1884,3814,49.4,27.4
臺北市,文山區,萬隆里,3016,1857,1159,23,3039,6067,50.09,30.61
臺北市,文山區,萬年里,2249,1287,962,26,2275,4515,50.39,28.5
臺北市,文山區,萬和里,1445,1011,434,13,1458,2826,51.59,35.77
臺北市,文山區,萬盛里,1947,1170,777,11,1958,3978,49.22,29.41
臺北市,文山區,興豐里,2122,1293,829,33,2155,4213,51.15,30.69
臺北市,文山區,興光里,1455,900,555,19,1474,3144,46.88,28.63
臺北市,文山區,興家里,3108,1969,1139,23,3131,6323,49.52,31.14
臺北市,文山區,興得里,2397,1493,904,33,2430,5161,47.08,28.93
臺北市,文山區,興業里,2263,1513,750,20,2283,4630,49.31,32.68
臺北市,文山區,興安里,2897,1851,1046,21,2918,5698,51.21,32.49
臺北市,文山區,興福里,2291,1329,962,23,2314,4637,49.9,28.66
臺北市,文山區,興旺里,3250,2133,1117,28,3278,7009,46.77,30.43
臺北市,文山區,興泰里,1726,1051,675,24,1750,3527,49.62,29.8
臺北市,文山區,興昌里,2707,1702,1005,27,2734,5643,48.45,30.16
臺北市,文山區,試院里,2903,1929,974,35,2938,5797,50.68,33.28
臺北市,文山區,華興里,3784,2397,1387,46,3830,7631,50.19,31.41
臺北市,文山區,明義里,1535,937,598,17,1552,3738,41.52,25.07
臺北市,文山區,明興里,2795,1762,1033,19,2814,5826,48.3,30.24
臺北市,文山區,木柵里,3834,2552,1282,45,3879,7776,49.88,32.82
臺北市,文山區,木新里,3450,1970,1480,39,3489,8867,39.35,22.22
臺北市,文山區,順興里,2980,1770,1210,24,3004,6234,48.19,28.39
臺北市,文山區,樟林里,3282,2111,1171,27,3309,7099,46.61,29.74
臺北市,文山區,樟新里,2293,1455,838,20,2313,4662,49.61,31.21
臺北市,文山區,樟腳里,2240,1320,920,26,2266,4648,48.75,28.4
臺北市,文山區,萬芳里,3197,2008,1189,27,3224,6704,48.09,29.95
臺北市,文山區,博嘉里,2352,1396,956,22,2374,5050,47.01,27.64
臺北市,文山區,萬興里,3500,2013,1487,33,3533,7045,50.15,28.57
臺北市,文山區,指南里,1532,831,701,12,1544,3435,44.95,24.19
臺北市,文山區,老泉里,345,137,208,4,349,778,44.86,17.61
臺北市,文山區,忠順里,1889,1261,628,25,1914,3647,52.48,34.58
臺北市,文山區,萬美里,2811,1759,1052,33,2844,6271,45.35,28.05
臺北市,文山區,政大里,3013,1826,1187,36,3049,6269,48.64,29.13
臺北市,文山區,樟文里,2444,1435,1009,30,2474,5223,47.37,27.47
臺北市,文山區,興邦里,2143,1474,669,19,2162,4301,50.27,34.27
臺北市,文山區,樟樹里,1910,1112,798,12,1922,3996,48.1,27.83
臺北市,南港區,南港里,2164,1119,1045,15,2179,5637,38.66,19.85
臺北市,南港區,中南里,1240,516,724,5,1245,3127,39.81,16.5
臺北市,南港區,新富里,1476,710,766,12,1488,3300,45.09,21.52
臺北市,南港區,三重里,2696,1450,1246,24,2720,6452,42.16,22.47
臺北市,南港區,東新里,2596,1345,1251,13,2609,6152,42.41,21.86
臺北市,南港區,新光里,1458,825,633,6,1464,3170,46.18,26.03
臺北市,南港區,東明里,2310,1302,1008,23,2333,4785,48.76,27.21
臺北市,南港區,西新里,1784,789,995,19,1803,4037,44.66,19.54
臺北市,南港區,玉成里,1844,895,949,21,1865,4075,45.77,21.96
臺北市,南港區,合成里,2695,1383,1312,27,2722,5716,47.62,24.2
臺北市,南港區,成福里,3039,1779,1260,27,3066,6413,47.81,27.74
臺北市,南港區,萬福里,1893,1085,808,13,1906,3623,52.61,29.95
臺北市,南港區,鴻福里,1857,996,861,13,1870,3885,48.13,25.64
臺北市,南港區,百福里,1996,1048,948,22,2018,4544,44.41,23.06
臺北市,南港區,聯成里,1996,1103,893,28,2024,4274,47.36,25.81
臺北市,南港區,舊莊里,3012,1545,1467,30,3042,7580,40.13,20.38
臺北市,南港區,中研里,3572,1858,1714,40,3612,7890,45.78,23.55
臺北市,南港區,九如里,2384,1414,970,26,2410,5386,44.75,26.25
臺北市,南港區,仁福里,2360,1489,871,18,2378,4777,49.78,31.17
臺北市,南港區,重陽里,2100,1186,914,17,2117,4541,46.62,26.12
臺北市,內湖區,西湖里,2882,1432,1450,32,2914,6163,47.28,23.24
臺北市,內湖區,西康里,3957,2263,1694,56,4013,8190,49.0,27.63
臺北市,內湖區,西安里,2749,1485,1264,31,2780,5644,49.26,26.31
臺北市,內湖區,港墘里,2464,1305,1159,16,2480,5115,48.48,25.51
臺北市,內湖區,港都里,2125,1099,1026,17,2142,4642,46.14,23.68
臺北市,內湖區,港富里,3764,2011,1753,28,3792,7960,47.64,25.26
臺北市,內湖區,港華里,3551,1891,1660,32,3583,7644,46.87,24.74
臺北市,內湖區,內湖里,2594,1473,1121,26,2620,5561,47.11,26.49
臺北市,內湖區,湖濱里,3659,2160,1499,31,3690,7099,51.98,30.43
臺北市,內湖區,紫星里,3328,1698,1630,30,3358,6865,48.91,24.73
臺北市,內湖區,大湖里,2213,1223,990,14,2227,4641,47.99,26.35
臺北市,內湖區,金龍里,2119,1193,926,25,2144,4647,46.14,25.67
臺北市,內湖區,金瑞里,2848,1489,1359,23,2871,5790,49.59,25.72
臺北市,內湖區,碧山里,2903,1631,1272,25,2928,6061,48.31,26.91
臺北市,內湖區,紫雲里,2363,1472,891,19,2382,4880,48.81,30.16
臺北市,內湖區,清白里,3537,1998,1539,22,3559,7269,48.96,27.49
臺北市,內湖區,葫洲里,2671,1562,1109,34,2705,5983,45.21,26.11
臺北市,內湖區,紫陽里,3382,1813,1569,31,3413,7104,48.04,25.52
臺北市,內湖區,瑞陽里,3402,2143,1259,41,3443,6596,52.2,32.49
臺北市,內湖區,瑞光里,1941,1200,741,22,1963,3925,50.01,30.57
臺北市,內湖區,五分里,3425,1789,1636,31,3456,8758,39.46,20.43
臺北市,內湖區,東湖里,2954,1582,1372,22,2976,6861,43.38,23.06
臺北市,內湖區,樂康里,2888,1561,1327,35,2923,6927,42.2,22.54
臺北市,內湖區,內溝里,1797,995,802,15,1812,4037,44.88,24.65
臺北市,內湖區,週美里,3304,1597,1707,36,3340,7466,44.74,21.39
臺北市,內湖區,行善里,2932,1492,1440,35,2967,6099,48.65,24.46
臺北市,內湖區,石潭里,1443,796,647,12,1455,3369,43.19,23.63
臺北市,內湖區,湖興里,2734,1485,1249,21,2755,7424,37.11,20.0
臺北市,內湖區,湖元里,2109,1090,1019,17,2126,4537,46.86,24.02
臺北市,內湖區,安湖里,2861,1500,1361,32,2893,6387,45.3,23.49
臺北市,內湖區,秀湖里,2584,1513,1071,30,2614,5366,48.71,28.2
臺北市,內湖區,安泰里,1952,1086,866,16,1968,4591,42.87,23.65
臺北市,內湖區,金湖里,3788,2127,1661,40,3828,8128,47.1,26.17
臺北市,內湖區,康寧里,3332,1929,1403,33,3365,7322,45.96,26.35
臺北市,內湖區,明湖里,1984,1016,968,19,2003,4501,44.5,22.57
臺北市,內湖區,蘆洲里,386,164,222,7,393,1126,34.9,14.56
臺北市,內湖區,麗山里,2289,1098,1191,18,2307,4994,46.2,21.99
臺北市,內湖區,寶湖里,3686,2126,1560,41,3727,7959,46.83,26.71
臺北市,內湖區,南湖里,2144,1232,912,24,2168,4674,46.38,26.36
臺北市,士林區,仁勇里,1545,639,906,15,1560,3285,47.49,19.45
臺北市,士林區,義信里,1234,616,618,12,1246,2736,45.54,22.51
臺北市,士林區,福林里,1133,554,579,18,1151,2482,46.37,22.32
臺北市,士林區,福德里,1829,947,882,19,1848,5079,36.39,18.65
臺北市,士林區,福志里,3372,1769,1603,26,3398,6507,52.22,27.19
臺北市,士林區,舊佳里,2593,1227,1366,24,2617,5295,49.42,23.17
臺北市,士林區,福佳里,3183,1517,1666,31,3214,6549,49.08,23.16
臺北市,士林區,後港里,2952,1268,1684,23,2975,6846,43.46,18.52
臺北市,士林區,福中里,2638,1112,1526,19,2657,5673,46.84,19.6
臺北市,士林區,前港里,1733,706,1027,18,1751,3851,45.47,18.33
臺北市,士林區,百齡里,2778,1199,1579,28,2806,5841,48.04,20.53
臺北市,士林區,承德里,2186,1130,1056,17,2203,4783,46.06,23.63
臺北市,士林區,福華里,2255,1011,1244,21,2276,5342,42.61,18.93
臺北市,士林區,明勝里,1988,936,1052,16,2004,4156,48.22,22.52
臺北市,士林區,福順里,2163,875,1288,32,2195,4679,46.91,18.7
臺北市,士林區,富光里,2244,898,1346,18,2262,5082,44.51,17.67
臺北市,士林區,葫蘆里,2901,1456,1445,30,2931,6264,46.79,23.24
臺北市,士林區,葫東里,1605,682,923,10,1615,3514,45.96,19.41
臺北市,士林區,社子里,2426,950,1476,20,2446,5517,44.34,17.22
臺北市,士林區,社新里,3264,1248,2016,29,3293,7737,42.56,16.13
臺北市,士林區,社園里,2767,1012,1755,25,2792,6210,44.96,16.3
臺北市,士林區,永倫里,2684,1009,1675,25,2709,6117,44.29,16.5
臺北市,士林區,福安里,1901,488,1413,14,1915,4416,43.37,11.05
臺北市,士林區,富洲里,2271,664,1607,20,2291,5424,42.24,12.24
臺北市,士林區,岩山里,1333,721,612,12,1345,2895,46.46,24.91
臺北市,士林區,名山里,3093,1599,1494,29,3122,6048,51.62,26.44
臺北市,士林區,德行里,1863,894,969,14,1877,3773,49.75,23.69
臺北市,士林區,德華里,2283,1047,1236,20,2303,4821,47.77,21.72
臺北市,士林區,聖山里,2130,1207,923,23,2153,4319,49.85,27.95
臺北市,士林區,忠誠里,2252,1385,867,21,2273,4739,47.96,29.23
臺北市,士林區,芝山里,3150,1572,1578,37,3187,6439,49.5,24.41
臺北市,士林區,東山里,2092,1203,889,28,2120,4371,48.5,27.52
臺北市,士林區,三玉里,2346,1200,1146,20,2366,4881,48.47,24.59
臺北市,士林區,蘭雅里,3433,1698,1735,33,3466,7425,46.68,22.87
臺北市,士林區,蘭興里,2680,1306,1374,19,2699,5452,49.5,23.95
臺北市,士林區,天福里,2418,1212,1206,30,2448,5286,46.31,22.93
臺北市,士林區,天祿里,2111,993,1118,16,2127,4413,48.2,22.5
臺北市,士林區,天壽里,2067,1037,1030,18,2085,4299,48.5,24.12
臺北市,士林區,天和里,2999,1541,1458,31,3030,6370,47.57,24.19
臺北市,士林區,天山里,2796,1463,1333,33,2829,5880,48.11,24.88
臺北市,士林區,天玉里,3529,1796,1733,34,3563,7345,48.51,24.45
臺北市,士林區,天母里,2679,1378,1301,33,2712,5559,48.79,24.79
臺北市,士林區,永福里,521,198,323,4,525,1083,48.48,18.28
臺北市,士林區,公館里,495,170,325,9,504,1228,41.04,13.84
臺北市,士林區,新安里,795,317,478,7,802,1668,48.08,19.0
臺北市,士林區,陽明里,1111,511,600,16,1127,2666,42.27,19.17
臺北市,士林區,菁山里,558,233,325,4,562,1421,39.55,16.4
臺北市,士林區,平等里,549,151,398,6,555,1306,42.5,11.56
臺北市,士林區,溪山里,566,232,334,6,572,1328,43.07,17.47
臺北市,士林區,翠山里,1196,796,400,13,1209,2345,51.56,33.94
臺北市,士林區,臨溪里,1157,603,554,12,1169,2508,46.61,24.04
臺北市,北投區,建民里,1847,823,1024,11,1858,3704,50.16,22.22
臺北市,北投區,文林里,1701,748,953,14,1715,3685,46.54,20.3
臺北市,北投區,石牌里,2141,966,1175,14,2155,4492,47.97,21.5
臺北市,北投區,福興里,2881,1393,1488,41,2922,5935,49.23,23.47
臺北市,北投區,榮光里,2589,1296,1293,37,2626,6019,43.63,21.53
臺北市,北投區,榮華里,3115,1552,1563,30,3145,6221,50.55,24.95
臺北市,北投區,裕民里,3048,1518,1530,24,3072,6632,46.32,22.89
臺北市,北投區,振華里,2986,1545,1441,19,3005,6389,47.03,24.18
臺北市,北投區,永和里,3709,1803,1906,33,3742,7885,47.46,22.87
臺北市,北投區,永欣里,3251,1734,1517,30,3281,6840,47.97,25.35
臺北市,北投區,永明里,1988,1011,977,17,2005,4020,49.88,25.15
臺北市,北投區,東華里,1887,1033,854,21,1908,3773,50.57,27.38
臺北市,北投區,吉利里,2594,1442,1152,24,2618,5623,46.56,25.64
臺北市,北投區,吉慶里,2001,893,1108,16,2017,4216,47.84,21.18
臺北市,北投區,尊賢里,1839,801,1038,13,1852,3960,46.77,20.23
臺北市,北投區,立賢里,2093,1003,1090,14,2107,4612,45.69,21.75
臺北市,北投區,立農里,3618,1730,1888,36,3654,7578,48.22,22.83
臺北市,北投區,八仙里,2142,1022,1120,19,2161,4729,45.7,21.61
臺北市,北投區,洲美里,935,337,598,6,941,1949,48.28,17.29
臺北市,北投區,奇岩里,4439,2144,2295,39,4478,9427,47.5,22.74
臺北市,北投區,清江里,3373,1584,1789,39,3412,8533,39.99,18.56
臺北市,北投區,中央里,3078,1371,1707,26,3104,7167,43.31,19.13
臺北市,北投區,長安里,2204,1029,1175,24,2228,5324,41.85,19.33
臺北市,北投區,大同里,2160,932,1228,30,2190,4700,46.6,19.83
臺北市,北投區,溫泉里,2609,1220,1389,25,2634,5643,46.68,21.62
臺北市,北投區,林泉里,1020,552,468,8,1028,2679,38.37,20.6
臺北市,北投區,中心里,2344,1228,1116,24,2368,5695,41.58,21.56
臺北市,北投區,中庸里,1533,705,828,15,1548,3547,43.64,19.88
臺北市,北投區,開明里,2685,1429,1256,27,2712,5783,46.9,24.71
臺北市,北投區,中和里,2075,1076,999,22,2097,4233,49.54,25.42
臺北市,北投區,智仁里,2254,1181,1073,16,2270,5189,43.75,22.76
臺北市,北投區,秀山里,1232,645,587,16,1248,2834,44.04,22.76
臺北市,北投區,文化里,1696,1136,560,23,1719,3518,48.86,32.29
臺北市,北投區,豐年里,1485,757,728,9,1494,3811,39.2,19.86
臺北市,北投區,稻香里,2055,1179,876,24,2079,4730,43.95,24.93
臺北市,北投區,桃源里,2386,1067,1319,25,2411,5227,46.13,20.41
臺北市,北投區,一德里,2718,1200,1518,39,2757,6316,43.65,19.0
臺北市,北投區,關渡里,4193,2051,2142,52,4245,9738,43.59,21.06
臺北市,北投區,泉源里,824,345,479,6,830,2119,39.17,16.28
臺北市,北投區,湖山里,582,266,316,7,589,1446,40.73,18.4
臺北市,北投區,大屯里,412,143,269,5,417,1087,38.36,13.16
臺北市,北投區,湖田里,316,146,170,3,319,826,38.62,17.68
新北市,板橋區,留侯里,702,394,308,3,705,1395,50.54,28.24
新北市,板橋區,流芳里,560,256,304,2,562,1228,45.77,20.85
新北市,板橋區,赤松里,420,210,210,2,422,838,50.36,25.06
新北市,板橋區,黃石里,466,198,268,6,472,1026,46.0,19.3
新北市,板橋區,挹秀里,829,473,356,6,835,1648,50.67,28.7
新北市,板橋區,湳興里,1908,932,976,25,1933,4525,42.72,20.6
新北市,板橋區,新興里,1140,543,597,11,1151,2846,40.44,19.08
新北市,板橋區,社後里,2468,1205,1263,23,2491,8998,27.68,13.39
新北市,板橋區,香社里,1728,740,988,18,1746,3907,44.69,18.94
新北市,板橋區,中正里,1875,869,1006,14,1889,4691,40.27,18.52
新北市,板橋區,自強里,2339,1343,996,13,2352,4425,53.15,30.35
新北市,板橋區,自立里,1150,506,644,10,1160,2471,46.94,20.48
新北市,板橋區,光華里,1107,568,539,7,1114,2357,47.26,24.1
新北市,板橋區,國光里,1790,1263,527,17,1807,3349,53.96,37.71
新北市,板橋區,港尾里,1226,616,610,8,1234,2463,50.1,25.01
新北市,板橋區,金華里,1457,633,824,12,1469,3446,42.63,18.37
新北市,板橋區,港德里,1695,703,992,17,1712,4107,41.68,17.12
新北市,板橋區,民權里,1139,592,547,12,1151,2304,49.96,25.69
新北市,板橋區,建國里,1430,609,821,13,1443,3109,46.41,19.59
新北市,板橋區,漢生里,1797,900,897,14,1811,3542,51.13,25.41
新北市,板橋區,公舘里,1457,614,843,20,1477,3318,44.51,18.51
新北市,板橋區,新民里,1667,811,856,13,1680,3648,46.05,22.23
新北市,板橋區,幸福里,1401,579,822,15,1416,3487,40.61,16.6
新北市,板橋區,忠誠里,1861,1290,571,17,1878,3605,52.09,35.78
新北市,板橋區,百壽里,1031,488,543,13,1044,2364,44.16,20.64
新北市,板橋區,介壽里,1076,527,549,17,1093,2555,42.78,20.63
新北市,板橋區,新埔里,933,405,528,5,938,1865,50.29,21.72
新北市,板橋區,華江里,2813,1358,1455,27,2840,6159,46.11,22.05
新北市,板橋區,江翠里,1930,782,1148,13,1943,4582,42.41,17.07
新北市,板橋區,純翠里,1980,811,1169,15,1995,4774,41.79,16.99
新北市,板橋區,溪頭里,2420,1029,1391,25,2445,5675,43.08,18.13
新北市,板橋區,聯翠里,1453,734,719,14,1467,3287,44.63,22.33
新北市,板橋區,宏翠里,1986,956,1030,16,2002,4715,42.46,20.28
新北市,板橋區,仁翠里,1129,412,717,11,1140,2555,44.62,16.13
新北市,板橋區,新翠里,3172,1370,1802,19,3191,7107,44.9,19.28
新北市,板橋區,吉翠里,1496,585,911,16,1512,3275,46.17,17.86
新北市,板橋區,德翠里,2759,1386,1373,28,2787,6174,45.14,22.45
新北市,板橋區,滿翠里,1131,411,720,6,1137,2666,42.65,15.42
新北市,板橋區,明翠里,1821,764,1057,22,1843,4242,43.45,18.01
新北市,板橋區,松翠里,1299,532,767,9,1308,2962,44.16,17.96
新北市,板橋區,柏翠里,1774,784,990,22,1796,4168,43.09,18.81
新北市,板橋區,龍翠里,1897,807,1090,22,1919,4391,43.7,18.38
新北市,板橋區,華翠里,1426,607,819,17,1443,3044,47.4,19.94
新北市,板橋區,忠翠里,4156,2017,2139,36,4192,9043,46.36,22.3
新北市,板橋區,嵐翠里,917,349,568,13,930,2150,43.26,16.23
新北市,板橋區,文翠里,1561,702,859,10,1571,3515,44.69,19.97
新北市,板橋區,青翠里,1119,453,666,12,1131,2638,42.87,17.17
新北市,板橋區,懷翠里,2074,840,1234,21,2095,5414,38.7,15.52
新北市,板橋區,福翠里,534,260,274,5,539,1221,44.14,21.29
新北市,板橋區,港嘴里,2286,1000,1286,18,2304,5318,43.32,18.8
新北市,板橋區,振興里,1802,796,1006,12,1814,3920,46.28,20.31
新北市,板橋區,振義里,1677,680,997,22,1699,3731,45.54,18.23
新北市,板橋區,光復里,1281,551,730,12,1293,2939,43.99,18.75
新北市,板橋區,埔墘里,2391,1090,1301,16,2407,5578,43.15,19.54
新北市,板橋區,長壽里,1190,526,664,11,1201,2572,46.7,20.45
新北市,板橋區,福壽里,1316,683,633,9,1325,2920,45.38,23.39
新北市,板橋區,海山里,2946,1377,1569,16,2962,6417,46.16,21.46
新北市,板橋區,九如里,1082,415,667,11,1093,2522,43.34,16.46
新北市,板橋區,玉光里,1882,824,1058,18,1900,4586,41.43,17.97
新北市,板橋區,光仁里,1121,513,608,15,1136,2444,46.48,20.99
新北市,板橋區,埤墘里,1788,795,993,18,1806,3765,47.97,21.12
新北市,板橋區,永安里,1323,519,804,13,1336,3069,43.53,16.91
新北市,板橋區,雙玉里,1576,678,898,19,1595,3525,45.25,19.23
新北市,板橋區,廣新里,1225,566,659,12,1237,3031,40.81,18.67
新北市,板橋區,深丘里,3217,1688,1529,34,3251,7123,45.64,23.7
新北市,板橋區,香丘里,1344,588,756,8,1352,3179,42.53,18.5
新北市,板橋區,西安里,1017,477,540,9,1026,2350,43.66,20.3
新北市,板橋區,東丘里,1763,718,1045,22,1785,3895,45.83,18.43
新北市,板橋區,長安里,1753,840,913,13,1766,3802,46.45,22.09
新北市,板橋區,福丘里,2008,1084,924,14,2022,4141,48.83,26.18
新北市,板橋區,福祿里,1468,819,649,9,1477,3382,43.67,24.22
新北市,板橋區,民族里,1759,858,901,16,1775,3878,45.77,22.12
新北市,板橋區,國泰里,1429,745,684,27,1456,3111,46.8,23.95
新北市,板橋區,福德里,2033,949,1084,14,2047,4371,46.83,21.71
新北市,板橋區,景星里,1289,658,631,13,1302,3021,43.1,21.78
新北市,板橋區,福星里,1502,749,753,16,1518,3064,49.54,24.45
新北市,板橋區,鄉雲里,1552,790,762,25,1577,3320,47.5,23.8
新北市,板橋區,廣德里,2626,1281,1345,25,2651,5909,44.86,21.68
新北市,板橋區,大豐里,1802,933,869,14,1816,4094,44.36,22.79
新北市,板橋區,重慶里,3115,1573,1542,29,3144,7469,42.09,21.06
新北市,板橋區,仁愛里,1235,715,520,12,1247,2702,46.15,26.46
新北市,板橋區,和平里,1400,792,608,15,1415,3281,43.13,24.14
新北市,板橋區,廣福里,1340,641,699,12,1352,3505,38.57,18.29
新北市,板橋區,華興里,1696,834,862,28,1724,3734,46.17,22.34
新北市,板橋區,華貴里,1034,464,570,15,1049,2257,46.48,20.56
新北市,板橋區,華德里,2439,1193,1246,34,2473,6150,40.21,19.4
新北市,板橋區,華東里,3341,1775,1566,33,3374,6979,48.35,25.43
新北市,板橋區,信義里,1600,784,816,13,1613,3812,42.31,20.57
新北市,板橋區,浮洲里,1351,535,816,15,1366,3334,40.97,16.05
新北市,板橋區,華中里,1919,779,1140,19,1938,4625,41.9,16.84
新北市,板橋區,僑中里,1437,578,859,8,1445,3700,39.05,15.62
新北市,板橋區,中山里,2493,1269,1224,32,2525,6074,41.57,20.89
新北市,板橋區,復興里,431,252,179,8,439,873,50.29,28.87
新北市,板橋區,大安里,1472,658,814,12,1484,3466,42.82,18.98
新北市,板橋區,福安里,2643,1429,1214,24,2667,6234,42.78,22.92
新北市,板橋區,聚安里,1782,760,1022,16,1798,4615,38.96,16.47
新北市,板橋區,龍安里,1064,441,623,23,1087,2464,44.12,17.9
新北市,板橋區,崑崙里,3326,1536,1790,42,3368,8523,39.52,18.02
新北市,板橋區,溪洲里,2011,907,1104,22,2033,5148,39.49,17.62
新北市,板橋區,溪北里,1288,599,689,18,1306,3079,42.42,19.45
新北市,板橋區,香雅里,1024,489,535,13,1037,2397,43.26,20.4
新北市,板橋區,新生里,1652,719,933,18,1670,3742,44.63,19.21
新北市,板橋區,文德里,1191,584,607,5,1196,2692,44.43,21.69
新北市,板橋區,文化里,1330,569,761,12,1342,2948,45.52,19.3
新北市,板橋區,新海里,1291,555,736,7,1298,3027,42.88,18.33
新北市,板橋區,莒光里,1135,466,669,10,1145,2449,46.75,19.03
新北市,板橋區,富貴里,996,471,525,15,1011,2040,49.56,23.09
新北市,板橋區,正泰里,1226,553,673,11,1237,2595,47.67,21.31
新北市,板橋區,民生里,901,394,507,9,910,1940,46.91,20.31
新北市,板橋區,後埔里,1536,765,771,13,1549,3280,47.23,23.32
新北市,板橋區,華福里,822,409,413,7,829,1789,46.34,22.86
新北市,板橋區,堂春里,1474,685,789,19,1493,3718,40.16,18.42
新北市,板橋區,成和里,2170,1022,1148,21,2191,6055,36.18,16.88
新北市,板橋區,光榮里,1031,541,490,6,1037,2287,45.34,23.66
新北市,板橋區,民安里,834,424,410,5,839,1772,47.35,23.93
新北市,板橋區,陽明里,1125,480,645,8,1133,2400,47.21,20.0
新北市,板橋區,朝陽里,1233,483,750,14,1247,2973,41.94,16.25
新北市,板橋區,松柏里,954,396,558,14,968,2012,48.11,19.68
新北市,板橋區,文聖里,1498,600,898,13,1511,3479,43.43,17.25
新北市,板橋區,居仁里,1434,623,811,16,1450,3379,42.91,18.44
新北市,板橋區,莊敬里,1658,797,861,21,1679,3540,47.43,22.51
新北市,板橋區,東安里,828,360,468,9,837,2026,41.31,17.77
新北市,板橋區,五權里,1577,712,865,18,1595,3585,44.49,19.86
新北市,板橋區,溪福里,4708,2295,2413,41,4749,12217,38.87,18.79
新北市,板橋區,大觀里,1247,494,753,13,1260,3210,39.25,15.39
新北市,板橋區,歡園里,498,180,318,2,500,1091,45.83,16.5
新北市,三重區,大有里,2040,820,1220,15,2055,4726,43.48,17.35
新北市,三重區,二重里,567,224,343,7,574,1436,39.97,15.6
新北市,三重區,頂崁里,965,339,626,4,969,2322,41.73,14.6
新北市,三重區,谷王里,441,185,256,7,448,904,49.56,20.46
新北市,三重區,中興里,1654,633,1021,11,1665,3568,46.66,17.74
新北市,三重區,德厚里,176,58,118,2,178,351,50.71,16.52
新北市,三重區,成功里,2611,1246,1365,18,2629,5671,46.36,21.97
新北市,三重區,福祉里,2169,958,1211,15,2184,4889,44.67,19.6
新北市,三重區,福民里,1317,535,782,12,1329,3007,44.2,17.79
新北市,三重區,過田里,2489,1169,1320,31,2520,8822,28.56,13.25
新北市,三重區,錦田里,830,354,476,5,835,1860,44.89,19.03
新北市,三重區,重明里,1502,658,844,13,1515,3239,46.77,20.31
新北市,三重區,光田里,1889,831,1058,20,1909,3937,48.49,21.11
新北市,三重區,光陽里,2720,1310,1410,25,2745,5711,48.07,22.94
新北市,三重區,田心里,1541,622,919,12,1553,3667,42.35,16.96
新北市,三重區,福田里,1460,623,837,20,1480,3107,47.63,20.05
新北市,三重區,田中里,2419,907,1512,32,2451,5458,44.91,16.62
新北市,三重區,田安里,2408,1038,1370,33,2441,5517,44.25,18.81
新北市,三重區,三民里,1184,478,706,13,1197,2877,41.61,16.61
新北市,三重區,光明里,2798,1305,1493,17,2815,6525,43.14,20.0
新北市,三重區,光正里,1087,539,548,7,1094,2380,45.97,22.65
新北市,三重區,同安里,487,217,270,7,494,1288,38.35,16.85
新北市,三重區,同慶里,695,310,385,3,698,1582,44.12,19.6
新北市,三重區,菜寮里,898,403,495,7,905,1982,45.66,20.33
新北市,三重區,永春里,733,343,390,9,742,1664,44.59,20.61
新北市,三重區,中正里,594,270,324,7,601,1261,47.66,21.41
新北市,三重區,吉利里,537,244,293,4,541,1289,41.97,18.93
新北市,三重區,大同里,768,336,432,2,770,1819,42.33,18.47
新北市,三重區,中民里,505,240,265,2,507,1130,44.87,21.24
新北市,三重區,平和里,613,286,327,7,620,1363,45.49,20.98
新北市,三重區,大安里,634,328,306,6,640,1483,43.16,22.12
新北市,三重區,仁德里,722,298,424,7,729,1785,40.84,16.69
新北市,三重區,忠孝里,711,305,406,8,719,1629,44.14,18.72
新北市,三重區,仁義里,512,230,282,4,516,1175,43.91,19.57
新北市,三重區,光榮里,536,240,296,6,542,1315,41.22,18.25
新北市,三重區,光輝里,612,272,340,4,616,1391,44.28,19.55
新北市,三重區,福星里,555,252,303,3,558,1098,50.82,22.95
新北市,三重區,福利里,921,446,475,9,930,2035,45.7,21.92
新北市,三重區,清和里,1686,872,814,24,1710,3628,47.13,24.04
新北市,三重區,永興里,609,281,328,3,612,1275,48.0,22.04
新北市,三重區,中山里,1081,465,616,12,1093,2448,44.65,19.0
新北市,三重區,大園里,997,415,582,13,1010,2453,41.17,16.92
新北市,三重區,國隆里,1139,570,569,10,1149,2406,47.76,23.69
新北市,三重區,重陽里,1321,581,740,10,1331,3178,41.88,18.28
新北市,三重區,民生里,1650,641,1009,11,1661,3797,43.75,16.88
新北市,三重區,重新里,645,224,421,7,652,1352,48.22,16.57
新北市,三重區,正德里,465,201,264,2,467,1030,45.34,19.51
新北市,三重區,正義里,776,324,452,6,782,1597,48.97,20.29
新北市,三重區,正安里,802,354,448,5,807,1771,45.57,19.99
新北市,三重區,自強里,694,287,407,9,703,1652,42.55,17.37
新北市,三重區,文化里,954,404,550,6,960,2007,47.83,20.13
新北市,三重區,中央里,686,266,420,5,691,1674,41.28,15.89
新北市,三重區,雙園里,394,200,194,5,399,855,46.67,23.39
新北市,三重區,錦通里,636,290,346,7,643,1344,47.84,21.58
新北市,三重區,錦安里,680,306,374,4,684,1672,40.91,18.3
新北市,三重區,長安里,818,327,491,9,827,1939,42.65,16.86
新北市,三重區,光華里,887,374,513,5,892,2070,43.09,18.07
新北市,三重區,長生里,347,139,208,6,353,813,43.42,17.1
新北市,三重區,開元里,652,290,362,15,667,1385,48.16,20.94
新北市,三重區,大德里,353,168,185,5,358,770,46.49,21.82
新北市,三重區,長元里,944,433,511,9,953,2229,42.75,19.43
新北市,三重區,長江里,815,323,492,13,828,1876,44.14,17.22
新北市,三重區,長泰里,849,359,490,7,856,2003,42.74,17.92
新北市,三重區,長福里,588,261,327,9,597,1436,41.57,18.18
新北市,三重區,介壽里,465,208,257,8,473,1039,45.52,20.02
新北市,三重區,萬壽里,815,378,437,14,829,1775,46.7,21.3
新北市,三重區,錦江里,805,322,483,8,813,2123,38.29,15.17
新北市,三重區,龍濱里,1269,539,730,12,1281,2926,43.78,18.42
新北市,三重區,龍門里,684,310,374,3,687,1678,40.94,18.47
新北市,三重區,秀江里,468,196,272,6,474,1136,41.73,17.25
新北市,三重區,奕壽里,725,294,431,4,729,1549,47.06,18.98
新北市,三重區,三安里,1003,447,556,8,1011,2410,41.95,18.55
新北市,三重區,福安里,1175,482,693,20,1195,2698,44.29,17.87
新北市,三重區,信安里,716,332,384,10,726,1802,40.29,18.42
新北市,三重區,安慶里,813,317,496,5,818,1889,43.3,16.78
新北市,三重區,幸福里,1781,702,1079,14,1795,4172,43.02,16.83
新北市,三重區,六合里,1450,602,848,21,1471,3336,44.09,18.05
新北市,三重區,六福里,2038,795,1243,17,2055,4936,41.63,16.11
新北市,三重區,順德里,887,379,508,15,902,2027,44.5,18.7
新北市,三重區,承德里,714,289,425,8,722,1631,44.27,17.72
新北市,三重區,瑞德里,935,397,538,12,947,2145,44.15,18.51
新北市,三重區,崇德里,1541,587,954,13,1554,3509,44.29,16.73
新北市,三重區,厚德里,1470,646,824,6,1476,3088,47.8,20.92
新北市,三重區,維德里,1173,485,688,12,1185,2545,46.56,19.06
新北市,三重區,尚德里,1126,479,647,7,1133,2674,42.37,17.91
新北市,三重區,培德里,1497,613,884,10,1507,3267,46.13,18.76
新北市,三重區,永德里,1812,694,1118,14,1826,4360,41.88,15.92
新北市,三重區,永盛里,1236,483,753,14,1250,2861,43.69,16.88
新北市,三重區,永福里,2050,808,1242,15,2065,4596,44.93,17.58
新北市,三重區,永清里,1896,630,1266,11,1907,4710,40.49,13.38
新北市,三重區,永安里,1512,615,897,15,1527,3553,42.98,17.31
新北市,三重區,永煇里,971,356,615,13,984,2263,43.48,15.73
新北市,三重區,溪美里,3385,1395,1990,37,3422,7625,44.88,18.3
新北市,三重區,福隆里,1618,648,970,16,1634,3940,41.47,16.45
新北市,三重區,五常里,1604,653,951,21,1625,3874,41.95,16.86
新北市,三重區,五福里,1352,551,801,10,1362,3407,39.98,16.17
新北市,三重區,仁忠里,1019,437,582,9,1028,2802,36.69,15.6
新北市,三重區,慈福里,863,314,549,6,869,1998,43.49,15.72
新北市,三重區,慈生里,931,375,556,12,943,2046,46.09,18.33
新北市,三重區,慈惠里,906,316,590,10,916,2029,45.15,15.57
新北市,三重區,慈愛里,1384,540,844,18,1402,3070,45.67,17.59
新北市,三重區,慈化里,930,361,569,7,937,2229,42.04,16.2
新北市,三重區,慈祐里,1823,724,1099,22,1845,4356,42.36,16.62
新北市,三重區,五華里,1931,734,1197,12,1943,4540,42.8,16.17
新北市,三重區,富貴里,2473,1151,1322,15,2488,5713,43.55,20.15
新北市,三重區,富華里,1146,493,653,12,1158,2882,40.18,17.11
新北市,三重區,富福里,682,263,419,4,686,1839,37.3,14.3
新北市,三重區,碧華里,3115,1457,1658,27,3142,7294,43.08,19.98
新北市,三重區,五谷里,820,333,487,5,825,1740,47.41,19.14
新北市,三重區,博愛里,1789,758,1031,18,1807,4013,45.03,18.89
新北市,三重區,福德里,1566,722,844,12,1578,3686,42.81,19.59
新北市,三重區,永吉里,1031,436,595,12,1043,2539,41.08,17.17
新北市,三重區,永發里,2243,827,1416,20,2263,5046,44.85,16.39
新北市,三重區,永順里,1661,624,1037,16,1677,4437,37.8,14.06
新北市,三重區,永豐里,2056,786,1270,29,2085,5061,41.2,15.53
新北市,三重區,立德里,1346,549,797,13,1359,2994,45.39,18.34
新北市,三重區,福樂里,1358,537,821,8,1366,3293,41.48,16.31
新北市,三重區,仁華里,1684,708,976,18,1702,3764,45.22,18.81
新北市,三重區,五順里,1346,544,802,10,1356,3524,38.48,15.44
新北市,中和區,中原里,2690,1388,1302,23,2713,6550,41.42,21.19
新北市,中和區,平河里,3634,2001,1633,32,3666,7974,45.97,25.09
新北市,中和區,信和里,1701,846,855,22,1723,3796,45.39,22.29
新北市,中和區,仁和里,1404,743,661,14,1418,3469,40.88,21.42
新北市,中和區,中正里,1354,687,667,13,1367,3452,39.6,19.9
新北市,中和區,建和里,1551,984,567,17,1568,3096,50.65,31.78
新北市,中和區,連和里,1029,679,350,5,1034,2171,47.63,31.28
新北市,中和區,連城里,2717,1639,1078,22,2739,5682,48.2,28.85
新北市,中和區,力行里,2524,1370,1154,22,2546,5265,48.36,26.02
新北市,中和區,枋寮里,1513,799,714,10,1523,3312,45.98,24.12
新北市,中和區,漳和里,1572,863,709,10,1582,3410,46.39,25.31
新北市,中和區,廟美里,1796,947,849,17,1813,3887,46.64,24.36
新北市,中和區,福真里,1680,865,815,21,1701,3709,45.86,23.32
新北市,中和區,福善里,1785,950,835,19,1804,3832,47.08,24.79
新北市,中和區,福美里,1872,1027,845,18,1890,3903,48.42,26.31
新北市,中和區,福祥里,2125,1088,1037,23,2148,4460,48.16,24.39
新北市,中和區,瓦磘里,2071,1078,993,19,2090,4916,42.51,21.93
新北市,中和區,福和里,1488,801,687,15,1503,3253,46.2,24.62
新北市,中和區,佳和里,2080,1164,916,37,2117,4420,47.9,26.33
新北市,中和區,安樂里,1678,1057,621,21,1699,3265,52.04,32.37
新北市,中和區,安和里,1407,811,596,10,1417,2767,51.21,29.31
新北市,中和區,安平里,2688,1751,937,40,2728,5289,51.58,33.11
新北市,中和區,中安里,2086,1337,749,12,2098,3903,53.75,34.26
新北市,中和區,泰安里,1467,841,626,17,1484,3171,46.8,26.52
新北市,中和區,新南里,3299,1950,1349,32,3331,7115,46.82,27.41
新北市,中和區,南山里,2149,1272,877,22,2171,4499,48.26,28.27
新北市,中和區,秀山里,1855,1136,719,18,1873,4018,46.62,28.27
新北市,中和區,秀成里,1438,844,594,13,1451,3062,47.39,27.56
新北市,中和區,秀福里,2066,1213,853,17,2083,4298,48.46,28.22
新北市,中和區,秀景里,2775,1775,1000,23,2798,5620,49.79,31.58
新北市,中和區,秀明里,2121,1447,674,21,2142,4436,48.29,32.62
新北市,中和區,秀峰里,2029,1289,740,23,2052,4318,47.52,29.85
新北市,中和區,秀仁里,1299,793,506,18,1317,2931,44.93,27.06
新北市,中和區,頂南里,1251,811,440,12,1263,2614,48.32,31.03
新北市,中和區,華新里,2726,1750,976,32,2758,6686,41.25,26.17
新北市,中和區,東南里,1792,1352,440,16,1808,3818,47.35,35.41
新北市,中和區,華南里,2006,1309,697,17,2023,4482,45.14,29.21
新北市,中和區,忠孝里,1713,1106,607,16,1729,4171,41.45,26.52
新北市,中和區,崇南里,1896,1241,655,38,1934,3856,50.16,32.18
新北市,中和區,景南里,1236,783,453,22,1258,2778,45.28,28.19
新北市,中和區,橫路里,140,63,77,2,142,310,45.81,20.32
新北市,中和區,內南里,1894,1166,728,22,1916,4421,43.34,26.37
新北市,中和區,壽南里,963,547,416,11,974,2183,44.62,25.06
新北市,中和區,外南里,1624,893,731,8,1632,6944,23.5,12.86
新北市,中和區,復興里,2065,1211,854,23,2088,4423,47.21,27.38
新北市,中和區,和興里,1895,1123,772,26,1921,3949,48.65,28.44
新北市,中和區,景平里,2385,1498,887,24,2409,4885,49.31,30.67
新北市,中和區,景新里,1542,917,625,17,1559,3210,48.57,28.57
新北市,中和區,景福里,2370,1473,897,31,2401,5145,46.67,28.63
新北市,中和區,景安里,2194,1347,847,26,2220,4350,51.03,30.97
新北市,中和區,景文里,1606,986,620,26,1632,3381,48.27,29.16
新北市,中和區,錦和里,2111,1149,962,21,2132,4740,44.98,24.24
新北市,中和區,錦昌里,950,589,361,8,958,1986,48.24,29.66
新北市,中和區,灰磘里,277,119,158,4,281,699,40.2,17.02
新北市,中和區,積穗里,3436,1807,1629,37,3473,7243,47.95,24.95
新北市,中和區,民享里,1083,466,617,5,1088,2221,48.99,20.98
新北市,中和區,員山里,2422,1234,1188,31,2453,5500,44.6,22.44
新北市,中和區,嘉穗里,1110,570,540,11,1121,2534,44.24,22.49
新北市,中和區,文元里,2040,969,1071,20,2060,4552,45.25,21.29
新北市,中和區,嘉新里,1470,736,734,17,1487,3544,41.96,20.77
新北市,中和區,民安里,1971,969,1002,18,1989,4463,44.57,21.71
新北市,中和區,安穗里,1710,799,911,11,1721,4026,42.75,19.85
新北市,中和區,瑞穗里,980,552,428,8,988,2090,47.27,26.41
新北市,中和區,明穗里,1830,872,958,12,1842,3932,46.85,22.18
新北市,中和區,清穗里,1308,643,665,6,1314,2811,46.74,22.87
新北市,中和區,自強里,1861,865,996,11,1872,4374,42.8,19.78
新北市,中和區,德穗里,1824,954,870,18,1842,4038,45.62,23.63
新北市,中和區,民生里,1750,872,878,24,1774,3746,47.36,23.28
新北市,中和區,國光里,1589,835,754,19,1608,3413,47.11,24.47
新北市,中和區,壽德里,1945,1313,632,29,1974,3950,49.97,33.24
新北市,中和區,明德里,1430,670,760,19,1449,3434,42.2,19.51
新北市,中和區,秀水里,1467,937,530,15,1482,3329,44.52,28.15
新北市,中和區,德行里,2813,1731,1082,29,2842,5696,49.89,30.39
新北市,中和區,宜安里,866,552,314,10,876,1721,50.9,32.07
新北市,中和區,安順里,1975,1225,750,32,2007,3886,51.65,31.52
新北市,中和區,秀義里,1196,674,522,9,1205,2405,50.1,28.02
新北市,中和區,秀士里,1011,664,347,9,1020,2226,45.82,29.83
新北市,中和區,興南里,1241,778,463,28,1269,2756,46.04,28.23
新北市,中和區,景本里,937,557,380,10,947,1883,50.29,29.58
新北市,中和區,福南里,1674,1093,581,20,1694,3773,44.9,28.97
新北市,中和區,中興里,2646,1594,1052,23,2669,5825,45.82,27.36
新北市,中和區,吉興里,1193,755,438,5,1198,2623,45.67,28.78
新北市,中和區,中山里,998,476,522,10,1008,2395,42.09,19.87
新北市,中和區,碧河里,2039,1099,940,22,2061,4326,47.64,25.4
新北市,中和區,錦中里,1552,807,745,19,1571,3643,43.12,22.15
新北市,中和區,錦盛里,1485,711,774,18,1503,3432,43.79,20.72
新北市,中和區,民有里,1172,605,567,12,1184,2486,47.63,24.34
新北市,中和區,員富里,1349,650,699,22,1371,3236,42.37,20.09
新北市,中和區,嘉慶里,1505,708,797,11,1516,3862,39.25,18.33
新北市,中和區,冠穗里,1451,698,753,18,1469,2946,49.86,23.69
新北市,中和區,國華里,1314,638,676,15,1329,2987,44.49,21.36
新北市,中和區,正南里,1280,836,444,18,1298,3087,42.05,27.08
新北市,中和區,正行里,1172,665,507,3,1175,2564,45.83,25.94
新北市,永和區,福林里,1366,819,547,13,1379,2917,47.27,28.08
新北市,永和區,文化里,1188,722,466,12,1200,2476,48.47,29.16
新北市,永和區,豫溪里,1563,1002,561,13,1576,4502,35.01,22.26
新北市,永和區,光明里,1337,836,501,14,1351,2581,52.34,32.39
新北市,永和區,仁愛里,1226,730,496,14,1240,2419,51.26,30.18
新北市,永和區,永貞里,1472,862,610,15,1487,2938,50.61,29.34
新北市,永和區,永福里,1240,745,495,9,1249,2396,52.13,31.09
新北市,永和區,民治里,1066,676,390,7,1073,2525,42.5,26.77
新北市,永和區,永成里,409,322,87,7,416,876,47.49,36.76
新北市,永和區,忠義里,347,273,74,5,352,704,50.0,38.78
新北市,永和區,永元里,1976,1192,784,22,1998,4085,48.91,29.18
新北市,永和區,秀林里,1712,916,796,9,1721,3437,50.07,26.65
新北市,永和區,保安里,3044,1775,1269,34,3078,6137,50.15,28.92
新北市,永和區,中溪里,2122,1186,936,17,2139,4473,47.82,26.51
新北市,永和區,永安里,1878,1151,727,9,1887,3634,51.93,31.67
新北市,永和區,民族里,1935,1206,729,20,1955,3986,49.05,30.26
新北市,永和區,民權里,1837,1121,716,13,1850,3852,48.03,29.1
新北市,永和區,中興里,1310,797,513,14,1324,2760,47.97,28.88
新北市,永和區,勵行里,489,233,256,6,495,1091,45.37,21.36
新北市,永和區,秀朗里,1521,862,659,13,1534,3358,45.68,25.67
新北市,永和區,秀成里,1202,687,515,7,1209,2545,47.5,26.99
新北市,永和區,上溪里,779,438,341,9,788,1702,46.3,25.73
新北市,永和區,竹林里,1487,951,536,25,1512,3222,46.93,29.52
新北市,永和區,雙和里,1761,1091,670,18,1779,3413,52.12,31.97
新北市,永和區,安和里,1664,1039,625,17,1681,3354,50.12,30.98
新北市,永和區,水源里,1791,1081,710,13,1804,3469,52.0,31.16
新北市,永和區,協和里,1272,747,525,10,1282,2623,48.88,28.48
新北市,永和區,河堤里,1382,875,507,11,1393,2995,46.51,29.22
新北市,永和區,頂溪里,1122,682,440,12,1134,2205,51.43,30.93
新北市,永和區,潭墘里,1973,1293,680,22,1995,3956,50.43,32.68
新北市,永和區,潭安里,2001,1291,710,27,2028,4105,49.4,31.45
新北市,永和區,大新里,1153,698,455,11,1164,2298,50.65,30.37
新北市,永和區,保平里,2024,1134,890,24,2048,4115,49.77,27.56
新北市,永和區,民本里,1506,877,629,12,1518,3433,44.22,25.55
新北市,永和區,民樂里,2055,1315,740,17,2072,4047,51.2,32.49
新北市,永和區,光復里,712,447,265,6,718,1527,47.02,29.27
新北市,永和區,復興里,1037,649,388,11,1048,2119,49.46,30.63
新北市,永和區,福和里,2202,1394,808,17,2219,4495,49.37,31.01
新北市,永和區,得和里,1933,1247,686,23,1956,3718,52.61,33.54
新北市,永和區,智光里,1220,748,472,15,1235,2845,43.41,26.29
新北市,永和區,新生里,385,278,107,3,388,809,47.96,34.36
新北市,永和區,大同里,442,329,113,4,446,907,49.17,36.27
新北市,永和區,前溪里,911,560,351,6,917,1894,48.42,29.57
新北市,永和區,和平里,1937,1162,775,22,1959,4232,46.29,27.46
新北市,永和區,新廍里,1012,620,392,11,1023,1996,51.25,31.06
新北市,永和區,下溪里,1913,1127,786,18,1931,3972,48.62,28.37
新北市,永和區,秀和里,2100,1264,836,17,2117,4293,49.31,29.44
新北市,永和區,河濱里,1324,774,550,10,1334,2797,47.69,27.67
新北市,永和區,民生里,1610,957,653,10,1620,3428,47.26,27.92
新北市,永和區,秀得里,1075,659,416,10,1085,2304,47.09,28.6
新北市,永和區,上林里,1511,999,512,23,1534,3036,50.53,32.91
新北市,永和區,網溪里,467,305,162,2,469,1031,45.49,29.58
新北市,永和區,正興里,923,561,362,18,941,1963,47.94,28.58
新北市,永和區,永興里,1282,791,491,18,1300,2764,47.03,28.62
新北市,永和區,桂林里,1494,994,500,14,1508,3259,46.27,30.5
新北市,永和區,店街里,1638,1020,618,14,1652,3607,45.8,28.28
新北市,永和區,信義里,1156,680,476,10,1166,2350,49.62,28.94
新北市,永和區,後溪里,900,482,418,8,908,1783,50.93,27.03
新北市,永和區,民富里,1155,676,479,12,1167,2527,46.18,26.75
新北市,永和區,秀元里,1267,754,513,12,1279,2627,48.69,28.7
新北市,永和區,永樂里,980,551,429,10,990,2095,47.26,26.3
新北市,永和區,保順里,4148,2527,1621,24,4172,9013,46.29,28.04
新北市,新莊區,海山里,2120,899,1221,16,2136,4736,45.1,18.98
新北市,新莊區,頭前里,3574,1572,2002,37,3611,8383,43.08,18.75
新北市,新莊區,國泰里,554,237,317,9,563,1293,43.54,18.33
新北市,新莊區,全安里,1861,805,1056,12,1873,3916,47.83,20.56
新北市,新莊區,福基里,2017,954,1063,13,2030,4570,44.42,20.88
新北市,新莊區,豐年里,1356,579,777,14,1370,3237,42.32,17.89
新北市,新莊區,忠孝里,2056,919,1137,14,2070,4625,44.76,19.87
新北市,新莊區,恆安里,1729,783,946,22,1751,3906,44.83,20.05
新北市,新莊區,後港里,2779,1188,1591,24,2803,6314,44.39,18.82
新北市,新莊區,文衡里,903,387,516,8,911,1879,48.48,20.6
新北市,新莊區,中美里,2330,1028,1302,20,2350,5211,45.1,19.73
新北市,新莊區,八德里,1022,435,587,8,1030,2744,37.54,15.85
新北市,新莊區,興漢里,1411,734,677,9,1420,2917,48.68,25.16
新北市,新莊區,中和里,1820,789,1031,16,1836,4028,45.58,19.59
新北市,新莊區,西盛里,4304,1917,2387,35,4339,10595,40.95,18.09
新北市,新莊區,榮和里,1298,611,687,8,1306,5142,25.4,11.88
新北市,新莊區,中泰里,1569,602,967,14,1583,3896,40.63,15.45
新北市,新莊區,瓊林里,2030,780,1250,17,2047,5058,40.47,15.42
新北市,新莊區,文德里,730,379,351,10,740,1553,47.65,24.4
新北市,新莊區,中誠里,757,282,475,9,766,1903,40.25,14.82
新北市,新莊區,裕民里,2392,986,1406,31,2423,6057,40.0,16.28
新北市,新莊區,文明里,663,283,380,10,673,1547,43.5,18.29
新北市,新莊區,中港里,2319,980,1339,28,2347,5390,43.54,18.18
新北市,新莊區,富國里,857,368,489,8,865,2056,42.07,17.9
新北市,新莊區,思源里,1981,812,1169,25,2006,4652,43.12,17.45
新北市,新莊區,立人里,840,519,321,9,849,1674,50.72,31.0
新北市,新莊區,南港里,1770,758,1012,20,1790,4664,38.38,16.25
新北市,新莊區,仁愛里,941,362,579,5,946,2389,39.6,15.15
新北市,新莊區,立德里,1048,493,555,3,1051,2305,45.6,21.39
新北市,新莊區,信義里,1875,824,1051,22,1897,4652,40.78,17.71
新北市,新莊區,立言里,1879,873,1006,15,1894,4324,43.8,20.19
新北市,新莊區,民安里,1967,891,1076,20,1987,5143,38.64,17.32
新北市,新莊區,和平里,1724,654,1070,15,1739,4178,41.62,15.65
新北市,新莊區,立功里,1248,518,730,10,1258,3266,38.52,15.86
新北市,新莊區,民本里,1004,381,623,10,1014,2666,38.03,14.29
新北市,新莊區,化成里,1489,595,894,7,1496,3422,43.72,17.39
新北市,新莊區,立志里,1483,599,884,14,1497,3451,43.38,17.36
新北市,新莊區,光華里,2231,987,1244,22,2253,6136,36.72,16.09
新北市,新莊區,思賢里,1625,689,936,14,1639,3692,44.39,18.66
新北市,新莊區,營盤里,770,341,429,5,775,1701,45.56,20.05
新北市,新莊區,光榮里,1345,627,718,10,1355,3835,35.33,16.35
新北市,新莊區,自強里,837,337,500,13,850,2341,36.31,14.4
新北市,新莊區,丹鳳里,2911,1375,1536,27,2938,7720,38.06,17.81
新北市,新莊區,光明里,1424,633,791,15,1439,4165,34.55,15.2
新北市,新莊區,自立里,1893,767,1126,32,1925,4667,41.25,16.43
新北市,新莊區,合鳳里,1499,621,878,14,1513,4014,37.69,15.47
新北市,新莊區,幸福里,1494,531,963,11,1505,3807,39.53,13.95
新北市,新莊區,雙鳳里,3798,1857,1941,32,3830,9790,39.12,18.97
新北市,新莊區,自信里,863,337,526,8,871,2188,39.81,15.4
新北市,新莊區,龍鳳里,3414,1606,1808,24,3438,8555,40.19,18.77
新北市,新莊區,中華里,1127,507,620,8,1135,2558,44.37,19.82
新北市,新莊區,中隆里,1704,750,954,16,1720,4343,39.6,17.27
新北市,新莊區,中原里,4528,2038,2490,40,4568,11108,41.12,18.35
新北市,新莊區,中信里,3010,1303,1707,24,3034,7280,41.68,17.9
新北市,新莊區,四維里,1465,605,860,17,1482,4090,36.23,14.79
新北市,新莊區,建福里,950,435,515,8,958,2178,43.99,19.97
新北市,新莊區,中宏里,1346,572,774,12,1358,3219,42.19,17.77
新北市,新莊區,中全里,1192,399,793,12,1204,3118,38.61,12.8
新北市,新莊區,立泰里,1856,854,1002,19,1875,4308,43.52,19.82
新北市,新莊區,全泰里,2092,1061,1031,19,2111,4287,49.24,24.75
新北市,新莊區,仁義里,1274,470,804,7,1281,3271,39.16,14.37
新北市,新莊區,立基里,2465,1135,1330,21,2486,5316,46.76,21.35
新北市,新莊區,昌明里,1367,597,770,15,1382,3181,43.45,18.77
新北市,新莊區,昌平里,2964,1474,1490,19,2983,7008,42.57,21.03
新北市,新莊區,文聖里,1434,709,725,12,1446,2960,48.85,23.95
新北市,新莊區,萬安里,1273,545,728,11,1284,3234,39.7,16.85
新北市,新莊區,龍安里,771,327,444,11,782,2075,37.69,15.76
新北市,新莊區,福營里,994,421,573,10,1004,2274,44.15,18.51
新北市,新莊區,後德里,1275,599,676,13,1288,2720,47.35,22.02
新北市,新莊區,建安里,2307,1006,1301,21,2328,5875,39.63,17.12
新北市,新莊區,成德里,1611,697,914,10,1621,4416,36.71,15.78
新北市,新莊區,福興里,2276,970,1306,22,2298,5247,43.8,18.49
新北市,新莊區,昌信里,1352,588,764,6,1358,3272,41.5,17.97
新北市,新莊區,昌隆里,1655,799,856,20,1675,3858,43.42,20.71
新北市,新莊區,中平里,3247,1621,1626,33,3280,7749,42.33,20.92
新北市,新莊區,立廷里,4164,2067,2097,34,4198,9967,42.12,20.74
新北市,新莊區,泰豐里,956,434,522,16,972,2206,44.06,19.67
新北市,新莊區,富民里,1446,658,788,14,1460,3404,42.89,19.33
新北市,新莊區,龍福里,795,384,411,9,804,1990,40.4,19.3
新北市,新莊區,祥鳳里,857,402,455,5,862,2133,40.41,18.85
新北市,新莊區,民全里,1334,571,763,6,1340,3307,40.52,17.27
新北市,新莊區,民有里,1534,713,821,16,1550,3548,43.69,20.1
新北市,新莊區,光正里,1449,662,787,25,1474,3815,38.64,17.35
新北市,新莊區,光和里,902,329,573,5,907,2430,37.33,13.54
新北市,新店區,國豐里,1416,949,467,12,1428,2846,50.18,33.35
新北市,新店區,明德里,1689,1095,594,10,1699,3541,47.98,30.92
新北市,新店區,大豐里,1602,978,624,5,1607,3306,48.61,29.58
新北市,新店區,大同里,1835,1127,708,16,1851,3497,52.93,32.23
新北市,新店區,江陵里,2481,1597,884,26,2507,4908,51.08,32.54
新北市,新店區,寶興里,2527,1585,942,27,2554,4879,52.35,32.49
新北市,新店區,寶安里,2459,1619,840,23,2482,4940,50.24,32.77
新北市,新店區,信義里,2992,1756,1236,25,3017,6086,49.57,28.85
新北市,新店區,忠孝里,1077,739,338,7,1084,2525,42.93,29.27
新北市,新店區,大鵬里,1407,1155,252,18,1425,2477,57.53,46.63
新北市,新店區,太平里,1276,827,449,12,1288,2805,45.92,29.48
新北市,新店區,頂城里,576,333,243,7,583,1541,37.83,21.61
新北市,新店區,下城里,1279,638,641,9,1288,2878,44.75,22.17
新北市,新店區,柴埕里,3367,2021,1346,27,3394,8098,41.91,24.96
新北市,新店區,永安里,1990,1128,862,14,2004,4606,43.51,24.49
新北市,新店區,公崙里,4949,3034,1915,44,4993,11616,42.98,26.12
新北市,新店區,德安里,2211,1235,976,27,2238,5492,40.75,22.49
新北市,新店區,雙城里,2114,1162,952,20,2134,5146,41.47,22.58
新北市,新店區,日興里,1985,1029,956,15,2000,5288,37.82,19.46
新北市,新店區,玫瑰里,2373,1531,842,10,2383,5383,44.27,28.44
新北市,新店區,塗潭里,377,94,283,5,382,928,41.16,10.13
新北市,新店區,美潭里,2083,1285,798,16,2099,4705,44.61,27.31
新北市,新店區,員潭里,1968,1186,782,18,1986,4714,42.13,25.16
新北市,新店區,雙坑里,249,102,147,6,255,726,35.12,14.05
新北市,新店區,粗坑里,1387,717,670,10,1397,2813,49.66,25.49
新北市,新店區,屈尺里,943,446,497,8,951,2253,42.21,19.8
新北市,新店區,龜山里,636,297,339,4,640,1598,40.05,18.59
新北市,新店區,廣興里,497,187,310,7,504,1264,39.87,14.79
新北市,新店區,直潭里,509,197,312,7,516,1196,43.14,16.47
新北市,新店區,青潭里,2052,1191,861,27,2079,4825,43.09,24.68
新北市,新店區,新店里,757,378,379,4,761,1629,46.72,23.2
新北市,新店區,張南里,1074,668,406,9,1083,2137,50.68,31.26
新北市,新店區,國校里,1028,589,439,9,1037,2320,44.7,25.39
新北市,新店區,文中里,733,477,256,8,741,1575,47.05,30.29
新北市,新店區,廣明里,410,187,223,7,417,782,53.32,23.91
新北市,新店區,文明里,1131,615,516,6,1137,2230,50.99,27.58
新北市,新店區,中興里,2400,1562,838,25,2425,6858,35.36,22.78
新北市,新店區,新生里,2618,1673,945,30,2648,5204,50.88,32.15
新北市,新店區,新德里,1080,625,455,12,1092,2418,45.16,25.85
新北市,新店區,張北里,3668,2411,1257,44,3712,8055,46.08,29.93
新北市,新店區,五峯里,3327,2109,1218,32,3359,6910,48.61,30.52
新北市,新店區,新安里,1748,1158,590,14,1762,3647,48.31,31.75
新北市,新店區,忠誠里,1151,735,416,8,1159,2185,53.04,33.64
新北市,新店區,中正里,2615,1703,912,30,2645,5458,48.46,31.2
新北市,新店區,中華里,1870,1267,603,22,1892,3832,49.37,33.06
新北市,新店區,仁愛里,923,621,302,11,934,1791,52.15,34.67
新北市,新店區,百忍里,1643,1086,557,20,1663,3376,49.26,32.17
新北市,新店區,百和里,1408,887,521,12,1420,2847,49.88,31.16
新北市,新店區,福德里,1565,1007,558,24,1589,3469,45.81,29.03
新北市,新店區,百福里,1675,1075,600,18,1693,3294,51.4,32.64
新北市,新店區,福民里,1837,1317,520,12,1849,3726,49.62,35.35
新北市,新店區,中山里,2313,1617,696,32,2345,4191,55.95,38.58
新北市,新店區,和平里,548,363,185,15,563,1240,45.4,29.27
新北市,新店區,中央里,2867,1914,953,24,2891,5278,54.77,36.26
新北市,新店區,明城里,1468,1011,457,6,1474,3130,47.09,32.3
新北市,新店區,安和里,3088,1829,1259,36,3124,7029,44.44,26.02
新北市,新店區,吉祥里,2029,1410,619,23,2052,4302,47.7,32.78
新北市,新店區,寶福里,3228,2019,1209,20,3248,6458,50.29,31.26
新北市,新店區,小城里,1652,1086,566,21,1673,3305,50.62,32.86
新北市,新店區,香坡里,4471,3006,1465,36,4507,10096,44.64,29.77
新北市,新店區,建國里,1388,978,410,11,1399,2786,50.22,35.1
新北市,新店區,復興里,1196,729,467,4,1200,2930,40.96,24.88
新北市,新店區,美城里,1135,699,436,12,1147,2466,46.51,28.35
新北市,新店區,安昌里,2246,1405,841,34,2280,4853,46.98,28.95
新北市,新店區,長春里,1226,794,432,9,1235,2304,53.6,34.46
新北市,新店區,新和里,1651,1089,562,21,1672,3718,44.97,29.29
新北市,新店區,永平里,2186,1308,878,23,2209,4949,44.64,26.43
新北市,新店區,達觀里,1667,1202,465,12,1679,3614,46.46,33.26
新北市,新店區,華城里,1304,807,497,15,1319,2551,51.71,31.63
新北市,樹林區,三多里,1388,547,841,13,1401,3594,38.98,15.22
新北市,樹林區,三福里,1334,621,713,19,1353,3437,39.37,18.07
新北市,樹林區,三興里,1570,686,884,10,1580,4203,37.59,16.32
新北市,樹林區,圳安里,1332,541,791,12,1344,3354,40.07,16.13
新北市,樹林區,保安里,2354,1042,1312,21,2375,5473,43.39,19.04
新北市,樹林區,潭底里,1550,648,902,13,1563,4463,35.02,14.52
新北市,樹林區,獇寮里,1548,600,948,13,1561,4406,35.43,13.62
新北市,樹林區,樹德里,1487,734,753,14,1501,3190,47.05,23.01
新北市,樹林區,樹西里,2094,976,1118,19,2113,4496,47.0,21.71
新北市,樹林區,樹南里,1628,733,895,8,1636,3699,44.23,19.82
新北市,樹林區,樹人里,1219,632,587,9,1228,2937,41.81,21.52
新北市,樹林區,坡內里,586,231,355,5,591,1506,39.24,15.34
新北市,樹林區,樹東里,443,215,228,3,446,1073,41.57,20.04
新北市,樹林區,大同里,1313,649,664,10,1323,3130,42.27,20.73
新北市,樹林區,和平里,1344,560,784,10,1354,3345,40.48,16.74
新北市,樹林區,彭厝里,1549,648,901,18,1567,4373,35.83,14.82
新北市,樹林區,彭福里,1816,799,1017,17,1833,4657,39.36,17.16
新北市,樹林區,東山里,1097,463,634,15,1112,2876,38.66,16.1
新北市,樹林區,東陽里,1984,920,1064,16,2000,5229,38.25,17.59
新北市,樹林區,東昇里,1769,779,990,22,1791,4435,40.38,17.56
新北市,樹林區,樂山里,627,276,351,7,634,1769,35.84,15.6
新北市,樹林區,東園里,603,177,426,2,605,1494,40.5,11.85
新北市,樹林區,西園里,633,210,423,14,647,1602,40.39,13.11
新北市,樹林區,南園里,5264,2914,2350,30,5294,12321,42.97,23.65
新北市,樹林區,北園里,786,279,507,10,796,1967,40.47,14.18
新北市,樹林區,柑園里,3493,1895,1598,26,3519,8030,43.82,23.6
新北市,樹林區,樹北里,428,202,226,2,430,853,50.41,23.68
新北市,樹林區,圳福里,1526,707,819,17,1543,3833,40.26,18.45
新北市,樹林區,樹興里,1323,622,701,17,1340,3184,42.09,19.54
新北市,樹林區,樹福里,1501,687,814,21,1522,3145,48.39,21.84
新北市,樹林區,光興里,1359,563,796,9,1368,3600,38.0,15.64
新北市,樹林區,金寮里,1468,606,862,18,1486,3906,38.04,15.51
新北市,樹林區,彭興里,1822,755,1067,13,1835,5086,36.08,14.84
新北市,樹林區,文林里,1838,835,1003,24,1862,4401,42.31,18.97
新北市,樹林區,山佳里,1871,806,1065,20,1891,5096,37.11,15.82
新北市,樹林區,中山里,1832,774,1058,25,1857,4640,40.02,16.68
新北市,樹林區,育英里,1244,568,676,13,1257,2790,45.05,20.36
新北市,樹林區,中華里,1106,526,580,11,1117,3019,37.0,17.42
新北市,樹林區,太順里,859,367,492,5,864,2412,35.82,15.22
新北市,樹林區,圳民里,1032,488,544,12,1044,2578,40.5,18.93
新北市,樹林區,圳生里,609,201,408,4,613,1430,42.87,14.06
新北市,樹林區,三龍里,818,335,483,7,825,1875,44.0,17.87
新北市,鶯歌區,東鶯里,439,203,236,7,446,946,47.15,21.46
新北市,鶯歌區,西鶯里,866,420,446,2,868,1968,44.11,21.34
新北市,鶯歌區,南鶯里,2133,955,1178,16,2149,4997,43.01,19.11
新北市,鶯歌區,北鶯里,1481,750,731,14,1495,3748,39.89,20.01
新北市,鶯歌區,中鶯里,466,198,268,2,468,940,49.79,21.06
新北市,鶯歌區,建德里,240,100,140,1,241,518,46.53,19.31
新北市,鶯歌區,同慶里,635,259,376,3,638,1386,46.03,18.69
新北市,鶯歌區,永昌里,2839,1309,1530,26,2865,7317,39.16,17.89
新北市,鶯歌區,南靖里,1317,545,772,12,1329,3154,42.14,17.28
新北市,鶯歌區,尖山里,2941,1319,1622,29,2970,7755,38.3,17.01
新北市,鶯歌區,二橋里,2654,1182,1472,24,2678,7334,36.51,16.12
新北市,鶯歌區,二甲里,374,160,214,7,381,836,45.57,19.14
新北市,鶯歌區,東湖里,149,59,90,1,150,250,60.0,23.6
新北市,鶯歌區,大湖里,1872,919,953,18,1890,4527,41.75,20.3
新北市,鶯歌區,鳳鳴里,1749,814,935,24,1773,4996,35.49,16.29
新北市,鶯歌區,鳳福里,1473,694,779,14,1487,3896,38.17,17.81
新北市,鶯歌區,永吉里,1705,809,896,23,1728,4275,40.42,18.92
新北市,鶯歌區,中湖里,1822,872,950,19,1841,5088,36.18,17.14
新北市,鶯歌區,鳳祥里,1441,633,808,19,1460,3878,37.65,16.32
新北市,鶯歌區,建國里,2310,1023,1287,18,2328,6172,37.72,16.57
新北市,三峽區,三峽里,162,74,88,2,164,285,57.54,25.96
新北市,三峽區,秀川里,226,98,128,4,230,575,40.0,17.04
新北市,三峽區,八張里,1355,692,663,11,1366,3542,38.57,19.54
新北市,三峽區,中埔里,1066,574,492,8,1074,3013,35.65,19.05
新北市,三峽區,弘道里,365,124,241,3,368,1027,35.83,12.07
新北市,三峽區,永舘里,2548,1131,1417,27,2575,6463,39.84,17.5
新北市,三峽區,礁溪里,1921,949,972,13,1934,5237,36.93,18.12
新北市,三峽區,鳶山里,3066,1497,1569,35,3101,8816,35.17,16.98
新北市,三峽區,龍埔里,3090,1559,1531,40,3130,8410,37.22,18.54
新北市,三峽區,大埔里,1345,708,637,12,1357,3676,36.92,19.26
新北市,三峽區,嘉添里,842,443,399,10,852,2111,40.36,20.99
新北市,三峽區,添福里,380,145,235,6,386,1045,36.94,13.88
新北市,三峽區,金圳里,176,66,110,4,180,486,37.04,13.58
新北市,三峽區,五寮里,234,110,124,2,236,794,29.72,13.85
新北市,三峽區,插角里,279,95,184,3,282,632,44.62,15.03
新北市,三峽區,有木里,216,76,140,2,218,683,31.92,11.13
新北市,三峽區,溪北里,869,361,508,10,879,2123,41.4,17.0
新北市,三峽區,溪南里,587,229,358,7,594,1375,43.2,16.65
新北市,三峽區,溪東里,985,458,527,11,996,2733,36.44,16.76
新北市,三峽區,成福里,398,159,239,2,400,860,46.51,18.49
新北市,三峽區,安坑里,450,156,294,7,457,1294,35.32,12.06
新北市,三峽區,竹崙里,641,234,407,3,644,1870,34.44,12.51
新北市,三峽區,介壽里,2007,888,1119,10,2017,6055,33.31,14.67
新北市,三峽區,安溪里,2324,1172,1152,21,2345,6654,35.24,17.61
新北市,三峽區,中正里,1582,739,843,17,1599,4616,34.64,16.01
新北市,三峽區,二鬮里,1200,650,550,14,1214,3228,37.61,20.14
新北市,三峽區,龍學里,5478,3192,2286,41,5519,12581,43.87,25.37
新北市,三峽區,龍恩里,2405,1380,1025,14,2419,5980,40.45,23.08
新北市,淡水區,中和里,194,64,130,3,197,557,35.37,11.49
新北市,淡水區,屯山里,323,120,203,4,327,994,32.9,12.07
新北市,淡水區,賢孝里,478,220,258,6,484,1447,33.45,15.2
新北市,淡水區,興仁里,572,259,313,2,574,1510,38.01,17.15
新北市,淡水區,蕃薯里,341,166,175,1,342,973,35.15,17.06
新北市,淡水區,義山里,801,389,412,12,813,2422,33.57,16.06
新北市,淡水區,忠山里,316,155,161,14,330,803,41.1,19.3
新北市,淡水區,崁頂里,6090,3467,2623,54,6144,17538,35.03,19.77
新北市,淡水區,埤島里,581,266,315,2,583,1616,36.08,16.46
新北市,淡水區,新興里,2527,1380,1147,20,2547,6573,38.75,20.99
新北市,淡水區,水碓里,1981,938,1043,23,2004,5098,39.31,18.4
新北市,淡水區,北投里,3652,2030,1622,35,3687,9067,40.66,22.39
新北市,淡水區,水源里,743,275,468,8,751,1974,38.04,13.93
新北市,淡水區,忠寮里,401,157,244,5,406,1054,38.52,14.9
新北市,淡水區,樹興里,545,266,279,9,554,1361,40.71,19.54
新北市,淡水區,坪頂里,545,266,279,3,548,1263,43.39,21.06
新北市,淡水區,福德里,3077,1713,1364,31,3108,6369,48.8,26.9
新北市,淡水區,竹圍里,2564,1399,1165,25,2589,5639,45.91,24.81
新北市,淡水區,民生里,2757,1421,1336,19,2776,6465,42.94,21.98
新北市,淡水區,八勢里,2575,1409,1166,20,2595,6014,43.15,23.43
新北市,淡水區,竿蓁里,4064,2314,1750,38,4102,10029,40.9,23.07
新北市,淡水區,鄧公里,2290,1237,1053,23,2313,5542,41.74,22.32
新北市,淡水區,中興里,1393,666,727,21,1414,3650,38.74,18.25
新北市,淡水區,長庚里,611,279,332,6,617,1326,46.53,21.04
新北市,淡水區,清文里,419,187,232,6,425,1068,39.79,17.51
新北市,淡水區,草東里,308,127,181,2,310,682,45.45,18.62
新北市,淡水區,協元里,518,233,285,4,522,1339,38.98,17.4
新北市,淡水區,永吉里,399,181,218,1,400,804,49.75,22.51
新北市,淡水區,民安里,313,135,178,10,323,624,51.76,21.63
新北市,淡水區,新生里,185,89,96,1,186,396,46.97,22.47
新北市,淡水區,文化里,664,365,299,8,672,1587,42.34,23.0
新北市,淡水區,油車里,2038,1105,933,24,2062,4932,41.81,22.4
新北市,淡水區,沙崙里,1591,859,732,9,1600,4158,38.48,20.66
新北市,淡水區,新義里,1347,610,737,16,1363,3658,37.26,16.68
新北市,淡水區,新春里,2936,1504,1432,24,2960,7974,37.12,18.86
新北市,淡水區,新民里,1755,896,859,18,1773,4269,41.53,20.99
新北市,淡水區,正德里,1640,909,731,17,1657,4169,39.75,21.8
新北市,淡水區,北新里,961,504,457,5,966,2486,38.86,20.27
新北市,淡水區,民權里,1927,951,976,14,1941,4221,45.98,22.53
新北市,淡水區,幸福里,1409,688,721,19,1428,3477,41.07,19.79
新北市,淡水區,學府里,1576,869,707,8,1584,4251,37.26,20.44
新北市,淡水區,大庄里,3813,2160,1653,34,3847,9198,41.82,23.48
新北市,汐止區,義民里,529,288,241,3,532,1238,42.97,23.26
新北市,汐止區,禮門里,448,205,243,4,452,980,46.12,20.92
新北市,汐止區,智慧里,1865,1095,770,15,1880,4239,44.35,25.83
新北市,汐止區,信望里,144,70,74,3,147,320,45.94,21.88
新北市,汐止區,橋東里,1239,642,597,15,1254,2889,43.41,22.22
新北市,汐止區,秀峰里,1414,690,724,12,1426,4888,29.17,14.12
新北市,汐止區,新昌里,1957,994,963,16,1973,4758,41.47,20.89
新北市,汐止區,復興里,3151,1758,1393,40,3191,6286,50.76,27.97
新北市,汐止區,茄苳里,1377,689,688,14,1391,3956,35.16,17.42
新北市,汐止區,長安里,632,302,330,7,639,1489,42.91,20.28
新北市,汐止區,保安里,544,264,280,7,551,1494,36.88,17.67
新北市,汐止區,保長里,1665,817,848,23,1688,4194,40.25,19.48
新北市,汐止區,鄉長里,936,440,496,4,940,2101,44.74,20.94
新北市,汐止區,江北里,2106,1064,1042,22,2128,5478,38.85,19.42
新北市,汐止區,拱北里,1596,824,772,12,1608,4648,34.6,17.73
新北市,汐止區,烘內里,626,320,306,7,633,1479,42.8,21.64
新北市,汐止區,八連里,341,148,193,1,342,921,37.13,16.07
新北市,汐止區,樟樹里,766,373,393,10,776,1990,38.99,18.74
新北市,汐止區,北峰里,1714,778,936,21,1735,4527,38.33,17.19
新北市,汐止區,北山里,2406,1271,1135,23,2429,5282,45.99,24.06
新北市,汐止區,白雲里,1596,822,774,19,1615,3974,40.64,20.68
新北市,汐止區,橫科里,1828,982,846,22,1850,4272,43.31,22.99
新北市,汐止區,東山里,216,107,109,2,218,542,40.22,19.74
新北市,汐止區,福山里,1544,867,677,14,1558,3388,45.99,25.59
新北市,汐止區,宜興里,1325,787,538,13,1338,2728,49.05,28.85
新北市,汐止區,中興里,2722,1386,1336,29,2751,7130,38.58,19.44
新北市,汐止區,湖光里,2476,1437,1039,24,2500,5589,44.73,25.71
新北市,汐止區,仁德里,741,386,355,6,747,1675,44.6,23.04
新北市,汐止區,厚德里,2444,1397,1047,16,2460,6767,36.35,20.64
新北市,汐止區,忠孝里,2934,1647,1287,23,2957,7500,39.43,21.96
新北市,汐止區,自強里,2149,1126,1023,16,2165,5118,42.3,22.0
新北市,汐止區,文化里,1723,920,803,16,1739,4130,42.11,22.28
新北市,汐止區,金龍里,1928,1003,925,23,1951,4841,40.3,20.72
新北市,汐止區,福德里,1128,569,559,15,1143,2985,38.29,19.06
新北市,汐止區,興福里,1268,701,567,6,1274,2904,43.87,24.14
新北市,汐止區,康福里,1866,961,905,20,1886,4716,39.99,20.38
新北市,汐止區,忠山里,1631,996,635,18,1649,3115,52.94,31.97
新北市,汐止區,環河里,514,192,322,3,517,1145,45.15,16.77
新北市,汐止區,東勢里,2072,1194,878,21,2093,4238,49.39,28.17
新北市,汐止區,山光里,892,537,355,9,901,2598,34.68,20.67
新北市,汐止區,大同里,1089,597,492,4,1093,2552,42.83,23.39
新北市,汐止區,崇德里,1918,1009,909,22,1940,4444,43.65,22.7
新北市,汐止區,湖興里,2736,1655,1081,27,2763,6020,45.9,27.49
新北市,汐止區,長青里,454,256,198,7,461,872,52.87,29.36
新北市,汐止區,福安里,2261,1153,1108,23,2284,5639,40.5,20.45
新北市,汐止區,秀山里,1677,902,775,12,1689,3952,42.74,22.82
新北市,汐止區,建成里,2124,1256,868,20,2144,4633,46.28,27.11
新北市,汐止區,城中里,1844,1072,772,17,1861,4091,45.49,26.2
新北市,汐止區,湖蓮里,1353,882,471,14,1367,2514,54.38,35.08
新北市,汐止區,保新里,1035,600,435,7,1042,2680,38.88,22.39
新北市,瑞芳區,龍潭里,304,159,145,2,306,728,42.03,21.84
新北市,瑞芳區,龍興里,779,423,356,14,793,1862,42.59,22.72
新北市,瑞芳區,龍鎮里,463,249,214,5,468,1203,38.9,20.7
新北市,瑞芳區,龍川里,586,321,265,8,594,1573,37.76,20.41
新北市,瑞芳區,龍山里,477,282,195,8,485,1281,37.86,22.01
新北市,瑞芳區,龍安里,216,120,96,6,222,598,37.12,20.07
新北市,瑞芳區,爪峯里,1293,624,669,15,1308,3539,36.96,17.63
新北市,瑞芳區,柑坪里,366,156,210,5,371,1041,35.64,14.99
新北市,瑞芳區,東和里,566,280,286,3,569,1589,35.81,17.62
新北市,瑞芳區,上天里,466,238,228,6,472,1272,37.11,18.71
新北市,瑞芳區,吉慶里,560,308,252,6,566,1680,33.69,18.33
新北市,瑞芳區,吉安里,982,499,483,9,991,2918,33.96,17.1
新北市,瑞芳區,傑魚里,666,293,373,4,670,1891,35.43,15.49
新北市,瑞芳區,猴硐里,141,57,84,1,142,434,32.72,13.13
新北市,瑞芳區,光復里,93,33,60,1,94,241,39.0,13.69
新北市,瑞芳區,弓橋里,116,40,76,3,119,264,45.08,15.15
新北市,瑞芳區,碩仁里,73,36,37,0,73,138,52.9,26.09
新北市,瑞芳區,基山里,182,84,98,1,183,417,43.88,20.14
新北市,瑞芳區,永慶里,128,62,66,0,128,408,31.37,15.2
新北市,瑞芳區,崇文里,115,49,66,1,116,296,39.19,16.55
新北市,瑞芳區,福住里,69,39,30,2,71,164,43.29,23.78
新北市,瑞芳區,頌德里,120,60,60,0,120,326,36.81,18.4
新北市,瑞芳區,新山里,106,60,46,3,109,339,32.15,17.7
新北市,瑞芳區,瓜山里,73,47,26,1,74,164,45.12,28.66
新北市,瑞芳區,銅山里,80,36,44,2,82,186,44.09,19.35
新北市,瑞芳區,石山里,110,66,44,0,110,321,34.27,20.56
新北市,瑞芳區,濓新里,79,37,42,1,80,286,27.97,12.94
新北市,瑞芳區,濓洞里,166,94,72,4,170,459,37.04,20.48
新北市,瑞芳區,海濱里,335,193,142,3,338,1241,27.24,15.55
新北市,瑞芳區,瑞濱里,591,310,281,5,596,1905,31.29,16.27
新北市,瑞芳區,深澳里,362,211,151,5,367,1290,28.45,16.36
新北市,瑞芳區,南雅里,118,53,65,2,120,264,45.45,20.08
新北市,瑞芳區,鼻頭里,265,111,154,5,270,853,31.65,13.01
新北市,瑞芳區,新峰里,909,490,419,8,917,3060,29.97,16.01
新北市,土城區,埤塘里,1286,591,695,11,1297,5065,25.61,11.67
新北市,土城區,土城里,738,366,372,14,752,1838,40.91,19.91
新北市,土城區,員林里,2581,1315,1266,22,2603,6368,40.88,20.65
新北市,土城區,員仁里,1839,876,963,23,1862,4879,38.16,17.95
新北市,土城區,長風里,989,723,266,9,998,1844,54.12,39.21
新北市,土城區,日新里,1718,786,932,18,1736,4107,42.27,19.14
新北市,土城區,日和里,2375,1024,1351,18,2393,5788,41.34,17.69
新北市,土城區,貨饒里,1610,700,910,12,1622,3999,40.56,17.5
新北市,土城區,柑林里,1318,658,660,19,1337,3209,41.66,20.5
新北市,土城區,埤林里,3172,1577,1595,21,3193,7337,43.52,21.49
新北市,土城區,瑞興里,1076,435,641,9,1085,2741,39.58,15.87
新北市,土城區,清水里,2800,1297,1503,28,2828,7167,39.46,18.1
新北市,土城區,清和里,1977,882,1095,24,2001,5572,35.91,15.83
新北市,土城區,永豐里,1488,792,696,16,1504,3780,39.79,20.95
新北市,土城區,清化里,575,243,332,8,583,1455,40.07,16.7
新北市,土城區,清溪里,2430,1245,1185,25,2455,6034,40.69,20.63
新北市,土城區,峯廷里,2362,1074,1288,33,2395,6492,36.89,16.54
新北市,土城區,平和里,2474,1100,1374,23,2497,6188,40.35,17.78
新北市,土城區,廷寮里,1737,770,967,16,1753,4348,40.32,17.71
新北市,土城區,大安里,1851,879,972,22,1873,4345,43.11,20.23
新北市,土城區,永寧里,2682,1290,1392,25,2707,7273,37.22,17.74
新北市,土城區,沛陂里,1727,770,957,28,1755,4244,41.35,18.14
新北市,土城區,頂埔里,1719,852,867,24,1743,4447,39.19,19.16
新北市,土城區,頂福里,1794,898,896,22,1816,4672,38.87,19.22
新北市,土城區,頂新里,1155,698,457,7,1162,2561,45.37,27.25
新北市,土城區,祖田里,570,216,354,4,574,1476,38.89,14.63
新北市,土城區,樂利里,1831,882,949,26,1857,4491,41.35,19.64
新北市,土城區,廣福里,2205,1129,1076,19,2224,4980,44.66,22.67
新北市,土城區,學府里,1272,587,685,14,1286,3076,41.81,19.08
新北市,土城區,延壽里,1525,717,808,9,1534,3907,39.26,18.35
新北市,土城區,安和里,1819,811,1008,14,1833,4353,42.11,18.63
新北市,土城區,青雲里,1162,557,605,16,1178,2751,42.82,20.25
新北市,土城區,員福里,1938,905,1033,16,1954,4879,40.05,18.55
新北市,土城區,延吉里,1432,615,817,17,1449,3854,37.6,15.96
新北市,土城區,復興里,1627,776,851,17,1644,3997,41.13,19.41
新北市,土城區,裕生里,1974,887,1087,19,1993,4880,40.84,18.18
新北市,土城區,員信里,1439,732,707,11,1450,3873,37.44,18.9
新北市,土城區,永富里,1811,877,934,19,1830,4972,36.81,17.64
新北市,土城區,學成里,1294,539,755,8,1302,2895,44.97,18.62
新北市,土城區,延和里,2359,1132,1227,20,2379,5897,40.34,19.2
新北市,土城區,中正里,1215,591,624,9,1224,2851,42.93,20.73
新北市,土城區,學士里,1873,932,941,19,1892,4214,44.9,22.12
新北市,土城區,明德里,2200,1152,1048,21,2221,5145,43.17,22.39
新北市,土城區,廣興里,1242,616,626,12,1254,3049,41.13,20.2
新北市,土城區,青山里,1080,476,604,3,1083,2621,41.32,18.16
新北市,土城區,金城里,1995,1136,859,15,2010,5390,37.29,21.08
新北市,土城區,延祿里,1297,587,710,12,1309,3708,35.3,15.83
新北市,蘆洲區,正義里,4818,2171,2647,43,4861,11581,41.97,18.75
新北市,蘆洲區,中原里,2041,854,1187,22,2063,5216,39.55,16.37
新北市,蘆洲區,中路里,1452,590,862,15,1467,3615,40.58,16.32
新北市,蘆洲區,光華里,1917,772,1145,16,1933,4716,40.99,16.37
新北市,蘆洲區,保佑里,1274,552,722,17,1291,3348,38.56,16.49
新北市,蘆洲區,水湳里,3640,1476,2164,41,3681,9167,40.15,16.1
新北市,蘆洲區,樓厝里,2455,1121,1334,24,2479,5872,42.22,19.09
新北市,蘆洲區,鷺江里,1935,802,1133,21,1956,4812,40.65,16.67
新北市,蘆洲區,恆德里,2242,1015,1227,17,2259,5571,40.55,18.22
新北市,蘆洲區,溪墘里,1230,456,774,13,1243,2798,44.42,16.3
新北市,蘆洲區,樹德里,1294,550,744,17,1311,2888,45.39,19.04
新北市,蘆洲區,保和里,939,390,549,13,952,2322,41.0,16.8
新北市,蘆洲區,仁復里,736,288,448,3,739,1885,39.2,15.28
新北市,蘆洲區,得勝里,1178,490,688,11,1189,2972,40.01,16.49
新北市,蘆洲區,南港里,1907,753,1154,31,1938,5162,37.54,14.59
新北市,蘆洲區,永樂里,2137,889,1248,19,2156,5439,39.64,16.34
新北市,蘆洲區,永康里,2240,870,1370,31,2271,5948,38.18,14.63
新北市,蘆洲區,信義里,1398,532,866,13,1411,3564,39.59,14.93
新北市,蘆洲區,玉清里,2193,956,1237,23,2216,5243,42.27,18.23
新北市,蘆洲區,復興里,1357,494,863,11,1368,3166,43.21,15.6
新北市,蘆洲區,水河里,3217,1274,1943,34,3251,8441,38.51,15.09
新北市,蘆洲區,仁愛里,1888,742,1146,16,1904,4663,40.83,15.91
新北市,蘆洲區,忠義里,1019,415,604,14,1033,2855,36.18,14.54
新北市,蘆洲區,九芎里,1862,776,1086,8,1870,4834,38.68,16.05
新北市,蘆洲區,中華里,1252,496,756,13,1265,2975,42.52,16.67
新北市,蘆洲區,得仁里,1230,493,737,20,1250,2688,46.5,18.34
新北市,蘆洲區,仁德里,1965,773,1192,18,1983,4838,40.99,15.98
新北市,蘆洲區,仁義里,1583,659,924,21,1604,4916,32.63,13.41
新北市,蘆洲區,光明里,1705,683,1022,18,1723,4262,40.43,16.03
新北市,蘆洲區,保新里,1323,562,761,15,1338,3431,39.0,16.38
新北市,蘆洲區,長安里,1623,569,1054,12,1635,4622,35.37,12.31
新北市,蘆洲區,民和里,1011,434,577,9,1020,2400,42.5,18.08
新北市,蘆洲區,忠孝里,875,310,565,6,881,2171,40.58,14.28
新北市,蘆洲區,福安里,1212,478,734,12,1224,2886,42.41,16.56
新北市,蘆洲區,永安里,1835,663,1172,19,1854,4625,40.09,14.34
新北市,蘆洲區,延平里,1478,581,897,15,1493,3685,40.52,15.77
新北市,蘆洲區,成功里,2585,1018,1567,31,2616,6695,39.07,15.21
新北市,蘆洲區,永德里,1405,563,842,20,1425,4010,35.54,14.04
新北市,五股區,興珍里,1735,598,1137,16,1751,4197,41.72,14.25
新北市,五股區,更寮里,487,121,366,5,492,1073,45.85,11.28
新北市,五股區,集福里,1481,669,812,15,1496,3475,43.05,19.25
新北市,五股區,觀音里,495,152,343,4,499,1260,39.6,12.06
新北市,五股區,成州里,1972,754,1218,19,1991,5457,36.49,13.82
新北市,五股區,成功里,2410,940,1470,19,2429,6462,37.59,14.55
新北市,五股區,五龍里,524,134,390,3,527,1245,42.33,10.76
新北市,五股區,五股里,1389,593,796,14,1403,3885,36.11,15.26
新北市,五股區,五福里,1241,545,696,8,1249,3097,40.33,17.6
新北市,五股區,德音里,1950,929,1021,18,1968,4718,41.71,19.69
新北市,五股區,陸一里,1044,838,206,15,1059,2315,45.75,36.2
新北市,五股區,貿商里,1244,890,354,16,1260,2648,47.58,33.61
新北市,五股區,德泰里,1552,759,793,15,1567,3948,39.69,19.22
新北市,五股區,成德里,1113,448,665,7,1120,3009,37.22,14.89
新北市,五股區,六福里,1353,672,681,21,1374,3460,39.71,19.42
新北市,五股區,集賢里,1491,564,927,11,1502,3661,41.03,15.41
新北市,五股區,民義里,1303,611,692,8,1311,3192,41.07,19.14
新北市,五股區,成泰里,3533,1553,1980,28,3561,9533,37.35,16.29
新北市,五股區,水碓里,2731,1131,1600,31,2762,7004,39.43,16.15
新北市,五股區,福德里,1020,453,567,11,1031,3018,34.16,15.01
新北市,泰山區,大科里,325,131,194,3,328,822,39.9,15.94
新北市,泰山區,黎明里,1222,576,646,10,1232,3030,40.66,19.01
新北市,泰山區,山腳里,2242,1056,1186,15,2257,5956,37.89,17.73
新北市,泰山區,福泰里,987,464,523,16,1003,2521,39.79,18.41
新北市,泰山區,楓樹里,1544,741,803,12,1556,3870,40.21,19.15
新北市,泰山區,同榮里,1510,764,746,13,1523,3617,42.11,21.12
新北市,泰山區,義學里,1666,781,885,16,1682,4172,40.32,18.72
新北市,泰山區,明志里,1449,701,748,9,1458,3385,43.07,20.71
新北市,泰山區,貴子里,1570,730,840,9,1579,3571,44.22,20.44
新北市,泰山區,貴和里,1818,936,882,14,1832,4404,41.6,21.25
新北市,泰山區,同興里,1377,592,785,11,1388,3234,42.92,18.31
新北市,泰山區,義仁里,2885,1320,1565,23,2908,7169,40.56,18.41
新北市,泰山區,泰友里,769,384,385,4,773,1857,41.63,20.68
新北市,泰山區,新明里,1145,521,624,12,1157,2868,40.34,18.17
新北市,泰山區,貴賢里,1534,769,765,10,1544,3300,46.79,23.3
新北市,泰山區,福興里,1254,642,612,15,1269,3114,40.75,20.62
新北市,泰山區,全興里,2928,1429,1499,25,2953,7587,38.92,18.83
新北市,林口區,東林里,1227,529,698,13,1240,3528,35.15,14.99
新北市,林口區,林口里,1734,857,877,13,1747,4811,36.31,17.81
新北市,林口區,西林里,3750,1947,1803,32,3782,9419,40.15,20.67
新北市,林口區,菁湖里,1652,705,947,16,1668,3771,44.23,18.7
新北市,林口區,中湖里,1552,699,853,12,1564,4170,37.51,16.76
新北市,林口區,湖北里,612,226,386,11,623,1384,45.01,16.33
新北市,林口區,湖南里,8361,4736,3625,62,8423,20700,40.69,22.88
新北市,林口區,南勢里,8644,4714,3930,81,8725,20299,42.98,23.22
新北市,林口區,東勢里,2724,1511,1213,25,2749,6489,42.36,23.29
新北市,林口區,頂福里,358,99,259,3,361,1010,35.74,9.8
新北市,林口區,下福里,451,198,253,6,457,1229,37.18,16.11
新北市,林口區,嘉寶里,398,142,256,3,401,911,44.02,15.59
新北市,林口區,瑞平里,262,98,164,1,263,763,34.47,12.84
新北市,林口區,太平里,462,147,315,4,466,1461,31.9,10.06
新北市,林口區,仁愛里,2516,1447,1069,20,2536,6006,42.22,24.09
新北市,林口區,麗林里,3148,1814,1334,30,3178,7589,41.88,23.9
新北市,林口區,麗園里,1552,820,732,21,1573,3627,43.37,22.61
新北市,深坑區,深坑里,1326,643,683,11,1337,3097,43.17,20.76
新北市,深坑區,萬順里,949,459,490,15,964,2316,41.62,19.82
新北市,深坑區,土庫里,1140,586,554,13,1153,2749,41.94,21.32
新北市,深坑區,昇高里,899,504,395,11,910,1926,47.25,26.17
新北市,深坑區,阿柔里,236,116,120,2,238,558,42.65,20.79
新北市,深坑區,埔新里,2423,1318,1105,24,2447,5654,43.28,23.31
新北市,深坑區,萬福里,1046,539,507,5,1051,2486,42.28,21.68
新北市,深坑區,賴仲里,964,574,390,8,972,2115,45.96,27.14
新北市,石碇區,石碇里,143,56,87,0,143,365,39.18,15.34
新北市,石碇區,潭邊里,290,149,141,3,293,798,36.72,18.67
新北市,石碇區,隆盛里,236,103,133,4,240,668,35.93,15.42
新北市,石碇區,烏塗里,243,88,155,2,245,607,40.36,14.5
新北市,石碇區,彭山里,103,47,56,3,106,296,35.81,15.88
新北市,石碇區,豐田里,184,81,103,1,185,387,47.8,20.93
新北市,石碇區,永定里,203,79,124,2,205,589,34.8,13.41
新北市,石碇區,中民里,248,99,149,3,251,717,35.01,13.81
新北市,石碇區,光明里,107,36,71,0,107,261,41.0,13.79
新北市,石碇區,豐林里,124,56,68,0,124,302,41.06,18.54
新北市,石碇區,永安里,314,103,211,5,319,809,39.43,12.73
新北市,石碇區,格頭里,411,138,273,3,414,991,41.78,13.93
新北市,坪林區,粗窟里,321,139,182,6,327,853,38.34,16.3
新北市,坪林區,坪林里,499,197,302,3,502,1290,38.91,15.27
新北市,坪林區,大林里,439,123,316,5,444,1167,38.05,10.54
新北市,坪林區,石𥕢里,134,46,88,5,139,420,33.1,10.95
新北市,坪林區,上德里,280,136,144,4,284,836,33.97,16.27
新北市,坪林區,水德里,212,85,127,0,212,631,33.6,13.47
新北市,坪林區,漁光里,312,96,216,4,316,860,36.74,11.16
新北市,三芝區,八賢里,106,30,76,1,107,311,34.41,9.65
新北市,三芝區,埔頭里,1550,822,728,17,1567,4787,32.73,17.17
新北市,三芝區,古庄里,381,192,189,3,384,1113,34.5,17.25
新北市,三芝區,新庄里,273,142,131,3,276,776,35.57,18.3
新北市,三芝區,埔坪里,1890,1016,874,30,1920,6124,31.35,16.59
新北市,三芝區,茂長里,277,150,127,2,279,604,46.19,24.83
新北市,三芝區,橫山里,160,94,66,2,162,477,33.96,19.71
新北市,三芝區,錫板里,280,126,154,5,285,661,43.12,19.06
新北市,三芝區,後厝里,777,467,310,3,780,2030,38.42,23.0
新北市,三芝區,福德里,302,154,148,2,304,762,39.9,20.21
新北市,三芝區,圓山里,157,65,92,1,158,532,29.7,12.22
新北市,三芝區,店子里,191,76,115,1,192,580,33.1,13.1
新北市,三芝區,興華里,433,172,261,8,441,1170,37.69,14.7
新北市,石門區,德茂里,334,149,185,8,342,1087,31.46,13.71
新北市,石門區,富基里,484,244,240,4,488,1316,37.08,18.54
新北市,石門區,老梅里,627,301,326,9,636,2052,30.99,14.67
新北市,石門區,山溪里,265,132,133,5,270,867,31.14,15.22
新北市,石門區,石門里,514,284,230,11,525,1496,35.09,18.98
新北市,石門區,尖鹿里,423,220,203,10,433,1452,29.82,15.15
新北市,石門區,乾華里,99,53,46,1,100,315,31.75,16.83
新北市,石門區,茂林里,192,100,92,2,194,589,32.94,16.98
新北市,石門區,草里里,260,135,125,1,261,915,28.52,14.75
新北市,八里區,龍源里,2774,1335,1439,26,2800,6740,41.54,19.81
新北市,八里區,米倉里,1193,572,621,6,1199,3256,36.82,17.57
新北市,八里區,大崁里,1208,491,717,6,1214,3091,39.28,15.88
新北市,八里區,埤頭里,1414,591,823,11,1425,3745,38.05,15.78
新北市,八里區,頂罟里,782,346,436,5,787,2139,36.79,16.18
新北市,八里區,舊城里,2323,964,1359,18,2341,6501,36.01,14.83
新北市,八里區,訊塘里,1458,583,875,20,1478,4113,35.93,14.17
新北市,八里區,荖阡里,561,245,316,4,565,1639,34.47,14.95
新北市,八里區,長坑里,507,198,309,8,515,1521,33.86,13.02
新北市,八里區,下罟里,495,216,279,6,501,1476,33.94,14.63
新北市,平溪區,薯榔里,134,53,81,0,134,361,37.12,14.68
新北市,平溪區,菁桐里,85,53,32,0,85,226,37.61,23.45
新北市,平溪區,白石里,95,43,52,2,97,229,42.36,18.78
新北市,平溪區,石底里,158,52,106,3,161,417,38.61,12.47
新北市,平溪區,平溪里,102,66,36,0,102,247,41.3,26.72
新北市,平溪區,嶺腳里,177,84,93,3,180,586,30.72,14.33
新北市,平溪區,東勢里,157,73,84,3,160,406,39.41,17.98
新北市,平溪區,望古里,57,24,33,1,58,154,37.66,15.58
新北市,平溪區,南山里,119,57,62,5,124,337,36.8,16.91
新北市,平溪區,平湖里,72,31,41,0,72,164,43.9,18.9
新北市,平溪區,十分里,247,130,117,13,260,798,32.58,16.29
新北市,平溪區,新寮里,40,19,21,0,40,151,26.49,12.58
新北市,雙溪區,雙溪里,176,101,75,3,179,444,40.32,22.75
新北市,雙溪區,共和里,133,56,77,1,134,363,36.91,15.43
新北市,雙溪區,新基里,295,164,131,9,304,713,42.64,23.0
新北市,雙溪區,魚行里,231,101,130,3,234,678,34.51,14.9
新北市,雙溪區,三港里,122,51,71,2,124,345,35.94,14.78
新北市,雙溪區,牡丹里,490,228,262,12,502,1416,35.45,16.1
新北市,雙溪區,三貂里,107,50,57,1,108,319,33.86,15.67
新北市,雙溪區,平林里,330,171,159,2,332,860,38.6,19.88
新北市,雙溪區,上林里,204,79,125,7,211,593,35.58,13.32
新北市,雙溪區,外柑里,162,79,83,1,163,394,41.37,20.05
新北市,雙溪區,長源里,109,30,79,0,109,351,31.05,8.55
新北市,雙溪區,泰平里,324,151,173,12,336,1129,29.76,13.37
新北市,貢寮區,貢寮里,318,142,176,2,320,823,38.88,17.25
新北市,貢寮區,吉林里,159,56,103,3,162,462,35.06,12.12
新北市,貢寮區,雙玉里,239,83,156,7,246,631,38.99,13.15
新北市,貢寮區,龍崗里,145,52,93,3,148,398,37.19,13.07
新北市,貢寮區,龍門里,280,70,210,4,284,630,45.08,11.11
新北市,貢寮區,福隆里,588,218,370,6,594,1599,37.15,13.63
新北市,貢寮區,仁里里,730,228,502,11,741,1652,44.85,13.8
新北市,貢寮區,真理里,731,149,582,18,749,1987,37.7,7.5
新北市,貢寮區,福連里,320,95,225,1,321,886,36.23,10.72
新北市,貢寮區,美豐里,292,95,197,7,299,716,41.76,13.27
新北市,貢寮區,和美里,341,86,255,0,341,981,34.76,8.77
新北市,金山區,和平里,190,102,88,1,191,456,41.89,22.37
新北市,金山區,大同里,242,119,123,4,246,712,34.55,16.71
新北市,金山區,豐漁里,195,85,110,0,195,502,38.84,16.93
新北市,金山區,磺港里,628,212,416,2,630,1719,36.65,12.33
新北市,金山區,美田里,1306,620,686,14,1320,3777,34.95,16.42
新北市,金山區,五湖里,599,295,304,6,605,1641,36.87,17.98
新北市,金山區,重和里,401,156,245,5,406,1182,34.35,13.2
新北市,金山區,兩湖里,122,56,66,1,123,377,32.63,14.85
新北市,金山區,六股里,237,82,155,7,244,643,37.95,12.75
新北市,金山區,三界里,234,94,140,3,237,619,38.29,15.19
新北市,金山區,清泉里,252,108,144,2,254,801,31.71,13.48
新北市,金山區,萬壽里,162,55,107,4,166,443,37.47,12.42
新北市,金山區,西湖里,71,31,40,2,73,177,41.24,17.51
新北市,金山區,永興里,178,69,109,4,182,570,31.93,12.11
新北市,金山區,金美里,1688,800,888,18,1706,4954,34.44,16.15
新北市,萬里區,萬里里,1465,731,734,20,1485,4232,35.09,17.27
新北市,萬里區,龜吼里,762,379,383,7,769,2548,30.18,14.87
新北市,萬里區,野柳里,1023,474,549,9,1032,3153,32.73,15.03
新北市,萬里區,大鵬里,942,464,478,17,959,2681,35.77,17.31
新北市,萬里區,磺潭里,182,91,91,3,185,574,32.23,15.85
新北市,萬里區,雙興里,321,126,195,9,330,966,34.16,13.04
新北市,萬里區,溪底里,201,65,136,3,204,659,30.96,9.86
新北市,萬里區,崁脚里,146,46,100,2,148,403,36.72,11.41
新北市,萬里區,中幅里,357,173,184,2,359,1107,32.43,15.63
新北市,萬里區,北基里,925,490,435,7,932,2751,33.88,17.81
新北市,烏來區,烏來里,777,462,315,9,786,2348,33.48,19.68
新北市,烏來區,忠治里,534,327,207,4,538,1572,34.22,20.8
新北市,烏來區,福山里,151,120,31,7,158,606,26.07,19.8
新北市,烏來區,信賢里,156,75,81,1,157,504,31.15,14.88
新北市,烏來區,孝義里,67,27,40,1,68,231,29.44,11.69
桃園市,桃園區,文化里,487,235,252,0,487,1024,47.56,22.95
桃園市,桃園區,文明里,691,347,344,4,695,1396,49.79,24.86
桃園市,桃園區,武陵里,621,306,315,6,627,1628,38.51,18.8
桃園市,桃園區,大林里,2540,1226,1314,20,2560,6940,36.89,17.67
桃園市,桃園區,忠義里,1367,777,590,10,1377,3581,38.45,21.7
桃園市,桃園區,會稽里,3775,2198,1577,22,3797,9791,38.78,22.45
桃園市,桃園區,長美里,468,164,304,3,471,1005,46.87,16.32
桃園市,桃園區,民生里,679,332,347,7,686,1649,41.6,20.13
桃園市,桃園區,永興里,745,306,439,7,752,1820,41.32,16.81
桃園市,桃園區,汴洲里,2594,1133,1461,21,2615,6542,39.97,17.32
桃園市,桃園區,永安里,2064,866,1198,22,2086,4520,46.15,19.16
桃園市,桃園區,東埔里,1874,836,1038,17,1891,4602,41.09,18.17
桃園市,桃園區,東門里,1361,719,642,7,1368,3019,45.31,23.82
桃園市,桃園區,東山里,808,383,425,9,817,1896,43.09,20.2
桃園市,桃園區,萬壽里,392,147,245,2,394,924,42.64,15.91
桃園市,桃園區,長安里,1483,645,838,9,1492,3527,42.3,18.29
桃園市,桃園區,中埔里,978,371,607,8,986,2382,41.39,15.58
桃園市,桃園區,西埔里,1332,544,788,13,1345,3082,43.64,17.65
桃園市,桃園區,西門里,637,310,327,7,644,1626,39.61,19.07
桃園市,桃園區,中和里,613,265,348,9,622,1307,47.59,20.28
桃園市,桃園區,文昌里,381,147,234,3,384,778,49.36,18.89
桃園市,桃園區,新埔里,4193,2334,1859,41,4234,9814,43.14,23.78
桃園市,桃園區,中山里,2874,1554,1320,23,2897,6789,42.67,22.89
桃園市,桃園區,慈文里,2446,1209,1237,19,2465,6329,38.95,19.1
桃園市,桃園區,西湖里,630,328,302,8,638,1430,44.62,22.94
桃園市,桃園區,南門里,2475,1239,1236,25,2500,5908,42.32,20.97
桃園市,桃園區,南華里,609,246,363,6,615,1365,45.05,18.02
桃園市,桃園區,玉山里,2061,942,1119,19,2080,4880,42.62,19.3
桃園市,桃園區,中成里,2254,1067,1187,21,2275,5722,39.76,18.65
桃園市,桃園區,中正里,2876,1541,1335,15,2891,6550,44.14,23.53
桃園市,桃園區,北門里,731,305,426,2,733,1710,42.87,17.84
桃園市,桃園區,雲林里,2628,1371,1257,22,2650,6053,43.78,22.65
桃園市,桃園區,福林里,2642,1343,1299,28,2670,5943,44.93,22.6
桃園市,桃園區,光興里,2137,972,1165,13,2150,4548,47.27,21.37
桃園市,桃園區,龍山里,1289,692,597,15,1304,3479,37.48,19.89
桃園市,桃園區,龍岡里,2319,1356,963,26,2345,5803,40.41,23.37
桃園市,桃園區,成功里,1799,968,831,19,1818,3846,47.27,25.17
桃園市,桃園區,青溪里,1829,805,1024,18,1847,4213,43.84,19.11
桃園市,桃園區,朝陽里,892,406,486,12,904,1970,45.89,20.61
桃園市,桃園區,中興里,2458,1172,1286,18,2476,5681,43.58,20.63
桃園市,桃園區,豐林里,2821,1421,1400,27,2848,6243,45.62,22.76
桃園市,桃園區,建國里,2205,1129,1076,41,2246,5129,43.79,22.01
桃園市,桃園區,大豐里,2038,978,1060,19,2057,4911,41.89,19.91
桃園市,桃園區,福安里,1751,910,841,15,1766,4122,42.84,22.08
桃園市,桃園區,三民里,1970,1127,843,13,1983,4162,47.65,27.08
桃園市,桃園區,大興里,1988,924,1064,14,2002,5398,37.09,17.12
桃園市,桃園區,春日里,2246,1087,1159,19,2265,6093,37.17,17.84
桃園市,桃園區,信光里,2770,1307,1463,27,2797,6914,40.45,18.9
桃園市,桃園區,中寧里,2414,1336,1078,12,2426,6089,39.84,21.94
桃園市,桃園區,同安里,3887,1974,1913,22,3909,9540,40.97,20.69
桃園市,桃園區,莊敬里,3705,2163,1542,24,3729,8779,42.48,24.64
桃園市,桃園區,文中里,1764,932,832,13,1777,3991,44.53,23.35
桃園市,桃園區,泰山里,1635,853,782,16,1651,3653,45.2,23.35
桃園市,桃園區,中路里,1605,845,760,15,1620,3883,41.72,21.76
桃園市,桃園區,中德里,2670,1343,1327,27,2697,6452,41.8,20.82
桃園市,桃園區,龍祥里,1819,1076,743,19,1838,4939,37.21,21.79
桃園市,桃園區,大有里,2395,1387,1008,19,2414,6433,37.53,21.56
桃園市,桃園區,寶山里,3156,1758,1398,23,3179,8491,37.44,20.7
桃園市,桃園區,龍鳳里,2978,1661,1317,22,3000,9776,30.69,16.99
桃園市,桃園區,龍安里,2091,1093,998,25,2116,5408,39.13,20.21
桃園市,桃園區,自強里,3218,1760,1458,35,3253,7355,44.23,23.93
桃園市,桃園區,中信里,2208,1163,1045,17,2225,5612,39.65,20.72
桃園市,桃園區,長德里,2198,1047,1151,12,2210,4931,44.82,21.23
桃園市,桃園區,中平里,1953,1065,888,19,1972,4612,42.76,23.09
桃園市,桃園區,中原里,2024,1152,872,9,2033,4570,44.49,25.21
桃園市,桃園區,中泰里,1825,1064,761,17,1842,4145,44.44,25.67
桃園市,桃園區,南埔里,2099,1037,1062,19,2118,4872,43.47,21.28
桃園市,桃園區,寶慶里,2559,1406,1153,26,2585,6169,41.9,22.79
桃園市,桃園區,北埔里,1914,1052,862,16,1930,4734,40.77,22.22
桃園市,桃園區,中聖里,2312,1408,904,17,2329,5481,42.49,25.69
桃園市,桃園區,龍壽里,2468,1281,1187,21,2489,6540,38.06,19.59
桃園市,桃園區,同德里,2584,1458,1126,20,2604,6061,42.96,24.06
桃園市,桃園區,明德里,1442,773,669,16,1458,3179,45.86,24.32
桃園市,桃園區,寶安里,3089,1692,1397,30,3119,8113,38.44,20.86
桃園市,桃園區,瑞慶里,2263,1209,1054,14,2277,5936,38.36,20.37
桃園市,桃園區,三元里,1528,800,728,15,1543,3791,40.7,21.1
桃園市,桃園區,大樹里,1493,740,753,10,1503,3881,38.73,19.07
桃園市,桃園區,大業里,2005,1086,919,12,2017,5006,40.29,21.69
桃園市,桃園區,福元里,1834,1026,808,5,1839,4546,40.45,22.57
桃園市,中壢區,龍平里,1288,984,304,12,1300,2898,44.86,33.95
桃園市,中壢區,龍昌里,2233,1440,793,25,2258,5428,41.6,26.53
桃園市,中壢區,仁德里,1274,796,478,18,1292,3064,42.17,25.98
桃園市,中壢區,永興里,395,204,191,1,396,914,43.33,22.32
桃園市,中壢區,內壢里,911,567,344,12,923,2196,42.03,25.82
桃園市,中壢區,成功里,1742,1046,696,18,1760,4380,40.18,23.88
桃園市,中壢區,光明里,2381,1387,994,25,2406,5320,45.23,26.07
桃園市,中壢區,自立里,2336,1941,395,23,2359,5087,46.37,38.16
桃園市,中壢區,自強里,1534,1032,502,6,1540,3497,44.04,29.51
桃園市,中壢區,中堅里,1503,992,511,14,1517,3778,40.15,26.26
桃園市,中壢區,龍興里,1785,1007,778,18,1803,4305,41.88,23.39
桃園市,中壢區,仁美里,2204,1362,842,16,2220,5566,39.89,24.47
桃園市,中壢區,仁愛里,1294,724,570,7,1301,3006,43.28,24.09
桃園市,中壢區,新街里,981,518,463,6,987,2310,42.73,22.42
桃園市,中壢區,中央里,1638,876,762,9,1647,3407,48.34,25.71
桃園市,中壢區,普仁里,1619,944,675,11,1630,4240,38.44,22.26
桃園市,中壢區,普義里,1733,1045,688,15,1748,5599,31.22,18.66
桃園市,中壢區,忠義里,1574,883,691,12,1586,3943,40.22,22.39
桃園市,中壢區,中正里,1985,1265,720,13,1998,5241,38.12,24.14
桃園市,中壢區,興仁里,1281,776,505,6,1287,3393,37.93,22.87
桃園市,中壢區,東興里,1483,783,700,12,1495,3315,45.1,23.62
桃園市,中壢區,洽溪里,2810,1409,1401,18,2828,6960,40.63,20.24
桃園市,中壢區,篤行里,1000,599,401,10,1010,2660,37.97,22.52
桃園市,中壢區,新明里,1579,751,828,13,1592,3765,42.28,19.95
桃園市,中壢區,新興里,1547,837,710,9,1556,3646,42.68,22.96
桃園市,中壢區,中原里,1560,840,720,8,1568,3654,42.91,22.99
桃園市,中壢區,內定里,2451,1149,1302,15,2466,6882,35.83,16.7
桃園市,中壢區,中壢里,292,152,140,3,295,674,43.77,22.55
桃園市,中壢區,龍岡里,1997,1317,680,26,2023,4607,43.91,28.59
桃園市,中壢區,仁祥里,1060,703,357,10,1070,2813,38.04,24.99
桃園市,中壢區,水尾里,1500,720,780,15,1515,3634,41.69,19.81
桃園市,中壢區,青埔里,2623,1359,1264,21,2644,6486,40.76,20.95
桃園市,中壢區,復興里,3479,1963,1516,30,3509,9665,36.31,20.31
桃園市,中壢區,文化里,3395,1799,1596,26,3421,8837,38.71,20.36
桃園市,中壢區,興國里,848,389,459,14,862,1888,45.66,20.6
桃園市,中壢區,忠福里,3163,1739,1424,25,3188,7822,40.76,22.23
桃園市,中壢區,信義里,1976,1161,815,14,1990,4334,45.92,26.79
桃園市,中壢區,石頭里,702,337,365,5,707,1585,44.61,21.26
桃園市,中壢區,龍東里,2060,1591,469,23,2083,4952,42.06,32.13
桃園市,中壢區,中建里,447,191,256,4,451,991,45.51,19.27
桃園市,中壢區,興南里,1275,726,549,17,1292,3012,42.9,24.1
桃園市,中壢區,後寮里,1829,1064,765,18,1847,4849,38.09,21.94
桃園市,中壢區,過嶺里,3011,1452,1559,26,3037,7935,38.27,18.3
桃園市,中壢區,五權里,2545,1301,1244,25,2570,6137,41.88,21.2
桃園市,中壢區,舊明里,704,325,379,9,713,1460,48.84,22.26
桃園市,中壢區,芝芭里,1710,749,961,15,1725,4196,41.11,17.85
桃園市,中壢區,月眉里,2099,733,1366,21,2120,5631,37.65,13.02
桃園市,中壢區,三民里,1267,563,704,9,1276,3254,39.21,17.3
桃園市,中壢區,山東里,1474,487,987,14,1488,3746,39.72,13.0
桃園市,中壢區,中榮里,382,188,194,4,386,827,46.67,22.73
桃園市,中壢區,內厝里,2043,882,1161,16,2059,4787,43.01,18.42
桃園市,中壢區,振興里,2099,1235,864,20,2119,4813,44.03,25.66
桃園市,中壢區,普慶里,1149,674,475,5,1154,2583,44.68,26.09
桃園市,中壢區,興和里,1224,565,659,10,1234,2700,45.7,20.93
桃園市,中壢區,永光里,2220,1151,1069,14,2234,5435,41.1,21.18
桃園市,中壢區,復華里,2228,1240,988,17,2245,5563,40.36,22.29
桃園市,中壢區,忠孝里,1869,1125,744,18,1887,4591,41.1,24.5
桃園市,中壢區,福德里,1211,722,489,12,1223,2834,43.15,25.48
桃園市,中壢區,和平里,1004,558,446,5,1009,2525,39.96,22.1
桃園市,中壢區,普忠里,1446,827,619,13,1459,3252,44.86,25.43
桃園市,中壢區,普強里,1688,1042,646,10,1698,3683,46.1,28.29
桃園市,中壢區,明德里,2038,1136,902,7,2045,4693,43.58,24.21
桃園市,中壢區,至善里,1426,972,454,8,1434,3713,38.62,26.18
桃園市,中壢區,五福里,1487,735,752,14,1501,3620,41.46,20.3
桃園市,中壢區,龍德里,1776,1095,681,11,1787,4104,43.54,26.68
桃園市,中壢區,正義里,1914,1052,862,12,1926,4282,44.98,24.57
桃園市,中壢區,龍安里,1012,782,230,8,1020,2050,49.76,38.15
桃園市,中壢區,中山里,1831,1178,653,13,1844,4761,38.73,24.74
桃園市,中壢區,德義里,1133,643,490,7,1140,2501,45.58,25.71
桃園市,中壢區,仁義里,1595,845,750,14,1609,3783,42.53,22.34
桃園市,中壢區,華勛里,1483,1050,433,13,1496,3965,37.73,26.48
桃園市,中壢區,仁福里,1842,1215,627,16,1858,4804,38.68,25.29
桃園市,中壢區,幸福里,2447,1326,1121,17,2464,6095,40.43,21.76
桃園市,中壢區,永福里,2434,1250,1184,13,2447,5469,44.74,22.86
桃園市,中壢區,仁和里,1385,861,524,15,1400,3582,39.08,24.04
桃園市,中壢區,華愛里,1354,875,479,17,1371,3555,38.57,24.61
桃園市,中壢區,莊敬里,1619,1248,371,21,1640,3413,48.05,36.57
桃園市,中壢區,自治里,1652,1261,391,15,1667,3620,46.05,34.83
桃園市,中壢區,健行里,1908,1103,805,16,1924,4454,43.2,24.76
桃園市,中壢區,興平里,1152,530,622,3,1155,2395,48.23,22.13
桃園市,中壢區,中興里,1351,871,480,11,1362,3376,40.34,25.8
桃園市,中壢區,龍慈里,2009,1326,683,13,2022,4787,42.24,27.7
桃園市,中壢區,自信里,2296,1474,822,15,2311,5590,41.34,26.37
桃園市,中壢區,林森里,1701,1016,685,12,1713,3821,44.83,26.59
桃園市,中壢區,金華里,2075,1312,763,17,2092,4035,51.85,32.52
桃園市,大溪區,興和里,670,250,420,6,676,1435,47.11,17.42
桃園市,大溪區,福仁里,454,156,298,3,457,963,47.46,16.2
桃園市,大溪區,一心里,1822,810,1012,12,1834,4760,38.53,17.02
桃園市,大溪區,一德里,1997,777,1220,26,2023,5582,36.24,13.92
桃園市,大溪區,月眉里,475,139,336,9,484,1237,39.13,11.24
桃園市,大溪區,永福里,431,123,308,5,436,964,45.23,12.76
桃園市,大溪區,美華里,1234,448,786,11,1245,3069,40.57,14.6
桃園市,大溪區,福安里,896,298,598,11,907,2222,40.82,13.41
桃園市,大溪區,復興里,345,117,228,8,353,859,41.09,13.62
桃園市,大溪區,新峰里,305,109,196,4,309,808,38.24,13.49
桃園市,大溪區,康安里,580,174,406,7,587,1300,45.15,13.38
桃園市,大溪區,義和里,726,256,470,5,731,1752,41.72,14.61
桃園市,大溪區,瑞興里,1000,381,619,13,1013,2714,37.32,14.04
桃園市,大溪區,中新里,673,233,440,7,680,1519,44.77,15.34
桃園市,大溪區,仁義里,1055,750,305,23,1078,2831,38.08,26.49
桃園市,大溪區,僑愛里,1091,903,188,7,1098,2488,44.13,36.29
桃園市,大溪區,仁善里,1780,917,863,13,1793,4490,39.93,20.42
桃園市,大溪區,仁愛里,1951,980,971,18,1969,5178,38.03,18.93
桃園市,大溪區,仁武里,1268,701,567,9,1277,3244,39.36,21.61
桃園市,大溪區,員林里,600,303,297,3,603,1577,38.24,19.21
桃園市,大溪區,南興里,1779,783,996,28,1807,5101,35.42,15.35
桃園市,大溪區,瑞源里,1449,641,808,11,1460,3734,39.1,17.17
桃園市,大溪區,光明里,922,575,347,19,941,2437,38.61,23.59
桃園市,大溪區,三元里,1198,800,398,15,1213,3012,40.27,26.56
桃園市,大溪區,田心里,1846,709,1137,19,1865,4436,42.04,15.98
桃園市,大溪區,仁文里,1474,822,652,13,1487,3897,38.16,21.09
桃園市,大溪區,仁和里,1813,942,871,20,1833,4772,38.41,19.74
桃園市,大溪區,仁美里,1243,696,547,12,1255,3309,37.93,21.03
桃園市,楊梅區,楊梅里,1577,952,625,7,1584,3845,41.2,24.76
桃園市,楊梅區,楊江里,469,283,186,5,474,1054,44.97,26.85
桃園市,楊梅區,紅梅里,1091,649,442,9,1100,2595,42.39,25.01
桃園市,楊梅區,永寧里,2470,1409,1061,12,2482,7481,33.18,18.83
桃園市,楊梅區,大平里,1136,707,429,8,1144,3148,36.34,22.46
桃園市,楊梅區,東流里,989,450,539,6,995,2934,33.91,15.34
桃園市,楊梅區,水美里,1606,863,743,14,1620,4097,39.54,21.06
桃園市,楊梅區,上田里,975,474,501,7,982,2632,37.31,18.01
桃園市,楊梅區,梅新里,797,487,310,5,802,1933,41.49,25.19
桃園市,楊梅區,大同里,1429,862,567,15,1444,3487,41.41,24.72
桃園市,楊梅區,埔心里,661,330,331,9,670,1355,49.45,24.35
桃園市,楊梅區,金龍里,563,404,159,10,573,1396,41.05,28.94
桃園市,楊梅區,瑞塘里,2155,1150,1005,16,2171,5757,37.71,19.98
桃園市,楊梅區,四維里,1904,1183,721,13,1917,4609,41.59,25.67
桃園市,楊梅區,梅溪里,1457,870,587,14,1471,4143,35.51,21.0
桃園市,楊梅區,高山里,1248,754,494,12,1260,3760,33.51,20.05
桃園市,楊梅區,高榮里,1377,677,700,10,1387,3518,39.43,19.24
桃園市,楊梅區,仁美里,1656,967,689,12,1668,3818,43.69,25.33
桃園市,楊梅區,光華里,1311,855,456,11,1322,3153,41.93,27.12
桃園市,楊梅區,富岡里,699,413,286,4,703,1787,39.34,23.11
桃園市,楊梅區,豐野里,1458,804,654,9,1467,3873,37.88,20.76
桃園市,楊梅區,員本里,1052,566,486,18,1070,2859,37.43,19.8
桃園市,楊梅區,瑞原里,1186,661,525,23,1209,3757,32.18,17.59
桃園市,楊梅區,三湖里,972,498,474,5,977,2794,34.97,17.82
桃園市,楊梅區,上湖里,1949,1114,835,19,1968,5853,33.62,19.03
桃園市,楊梅區,中山里,1208,723,485,7,1215,2986,40.69,24.21
桃園市,楊梅區,楊明里,2751,1607,1144,14,2765,7742,35.71,20.76
桃園市,楊梅區,金溪里,1646,1057,589,15,1661,4048,41.03,26.11
桃園市,楊梅區,裕成里,1475,917,558,15,1490,3286,45.34,27.91
桃園市,楊梅區,秀才里,1331,698,633,13,1344,3311,40.59,21.08
桃園市,楊梅區,青山里,1430,842,588,11,1441,4482,32.15,18.79
桃園市,楊梅區,新榮里,1417,753,664,15,1432,3453,41.47,21.81
桃園市,楊梅區,雙榮里,1416,746,670,13,1429,3233,44.2,23.07
桃園市,楊梅區,瑞坪里,2094,1272,822,10,2104,5934,35.46,21.44
桃園市,楊梅區,永平里,741,446,295,8,749,1966,38.1,22.69
桃園市,楊梅區,瑞溪里,1185,718,467,8,1193,3639,32.78,19.73
桃園市,楊梅區,高上里,972,509,463,7,979,2766,35.39,18.4
桃園市,楊梅區,富豐里,1024,523,501,9,1033,3030,34.09,17.26
桃園市,楊梅區,裕新里,853,530,323,2,855,2486,34.39,21.32
桃園市,楊梅區,三民里,1194,718,476,7,1201,3449,34.82,20.82
桃園市,楊梅區,頭湖里,1023,573,450,7,1030,2900,35.52,19.76
桃園市,蘆竹區,新興里,1246,414,832,12,1258,2950,42.64,14.03
桃園市,蘆竹區,中福里,1650,582,1068,18,1668,4062,41.06,14.33
桃園市,蘆竹區,新莊里,1993,799,1194,17,2010,5043,39.86,15.84
桃園市,蘆竹區,大竹里,1932,915,1017,18,1950,4969,39.24,18.41
桃園市,蘆竹區,蘆竹里,1573,572,1001,15,1588,4036,39.35,14.17
桃園市,蘆竹區,南崁里,1538,742,796,11,1549,3675,42.15,20.19
桃園市,蘆竹區,錦興里,1608,743,865,12,1620,3906,41.47,19.02
桃園市,蘆竹區,五福里,1022,517,505,4,1026,2425,42.31,21.32
桃園市,蘆竹區,內厝里,915,340,575,9,924,2595,35.61,13.1
桃園市,蘆竹區,山鼻里,594,252,342,9,603,1778,33.91,14.17
桃園市,蘆竹區,山腳里,1309,438,871,18,1327,3579,37.08,12.24
桃園市,蘆竹區,外社里,620,158,462,10,630,1486,42.4,10.63
桃園市,蘆竹區,坑子里,617,178,439,7,624,1673,37.3,10.64
桃園市,蘆竹區,坑口里,972,339,633,13,985,2501,39.38,13.55
桃園市,蘆竹區,海湖里,927,466,461,12,939,2969,31.63,15.7
桃園市,蘆竹區,南榮里,1522,746,776,19,1541,3532,43.63,21.12
桃園市,蘆竹區,南興里,2186,1188,998,18,2204,5162,42.7,23.01
桃園市,蘆竹區,長興里,860,387,473,9,869,2582,33.66,14.99
桃園市,蘆竹區,錦中里,1322,629,693,12,1334,3128,42.65,20.11
桃園市,蘆竹區,富竹里,578,156,422,3,581,1327,43.78,11.76
桃園市,蘆竹區,上竹里,1427,663,764,13,1440,3516,40.96,18.86
桃園市,蘆竹區,宏竹里,1165,464,701,14,1179,2982,39.54,15.56
桃園市,蘆竹區,瓦窯里,1276,705,571,14,1290,3360,38.39,20.98
桃園市,蘆竹區,營盤里,1933,1032,901,22,1955,4886,40.01,21.12
桃園市,蘆竹區,羊稠里,1912,966,946,16,1928,4459,43.24,21.66
桃園市,蘆竹區,順興里,1520,764,756,4,1524,3985,38.24,19.17
桃園市,蘆竹區,福昌里,1964,1095,869,9,1973,5062,38.98,21.63
桃園市,蘆竹區,福興里,1352,704,648,6,1358,3442,39.45,20.45
桃園市,蘆竹區,蘆興里,596,265,331,5,601,1633,36.8,16.23
桃園市,蘆竹區,長壽里,2341,1297,1044,18,2359,5584,42.25,23.23
桃園市,蘆竹區,吉祥里,1747,1046,701,24,1771,3690,47.99,28.35
桃園市,蘆竹區,中山里,1224,677,547,11,1235,3243,38.08,20.88
桃園市,蘆竹區,福祿里,1176,568,608,6,1182,3227,36.63,17.6
桃園市,蘆竹區,興榮里,1231,653,578,9,1240,2793,44.4,23.38
桃園市,蘆竹區,中興里,1810,857,953,15,1825,5074,35.97,16.89
桃園市,蘆竹區,上興里,1373,657,716,6,1379,3380,40.8,19.44
桃園市,蘆竹區,營福里,1282,640,642,8,1290,3296,39.14,19.42
桃園市,蘆竹區,正興里,1516,721,795,4,1520,4443,34.21,16.23
桃園市,蘆竹區,濱海里,759,323,436,13,772,2532,30.49,12.76
桃園市,大園區,大園里,2341,1069,1272,16,2357,6107,38.6,17.5
桃園市,大園區,田心里,2517,1100,1417,21,2538,6972,36.4,15.78
桃園市,大園區,溪海里,1475,639,836,15,1490,4705,31.67,13.58
桃園市,大園區,和平里,642,225,417,4,646,1612,40.07,13.96
桃園市,大園區,橫峰里,4567,2188,2379,38,4605,11610,39.66,18.85
桃園市,大園區,五權里,1982,726,1256,16,1998,5222,38.26,13.9
桃園市,大園區,埔心里,2153,910,1243,15,2168,5896,36.77,15.43
桃園市,大園區,大海里,654,370,284,8,662,1650,40.12,22.42
桃園市,大園區,三石里,1204,499,705,11,1215,2851,42.62,17.5
桃園市,大園區,菓林里,2489,1134,1355,26,2515,7202,34.92,15.75
桃園市,大園區,竹圍里,1192,577,615,8,1200,3212,37.36,17.96
桃園市,大園區,海口里,602,353,249,5,607,1863,32.58,18.95
桃園市,大園區,沙崙里,881,409,472,7,888,2595,34.22,15.76
桃園市,大園區,後厝里,819,388,431,3,822,2523,32.58,15.38
桃園市,大園區,圳頭里,944,397,547,10,954,2566,37.18,15.47
桃園市,大園區,內海里,755,304,451,7,762,2154,35.38,14.11
桃園市,大園區,北港里,954,365,589,13,967,2912,33.21,12.53
桃園市,大園區,南港里,1734,845,889,12,1746,5701,30.63,14.82
桃園市,龜山區,楓樹里,1704,755,949,6,1710,3984,42.92,18.95
桃園市,龜山區,龜山里,2586,1278,1308,19,2605,6579,39.6,19.43
桃園市,龜山區,兔坑里,1561,736,825,10,1571,4492,34.97,16.38
桃園市,龜山區,大同里,2218,1124,1094,20,2238,5834,38.36,19.27
桃園市,龜山區,山福里,1266,610,656,15,1281,3262,39.27,18.7
桃園市,龜山區,山頂里,1959,1000,959,16,1975,5439,36.31,18.39
桃園市,龜山區,陸光里,1772,1543,229,29,1801,3606,49.94,42.79
桃園市,龜山區,精忠里,2157,1457,700,26,2183,5179,42.15,28.13
桃園市,龜山區,公西里,626,289,337,7,633,1298,48.77,22.27
桃園市,龜山區,樂善里,1920,855,1065,14,1934,5523,35.02,15.48
桃園市,龜山區,南上里,796,338,458,4,800,1874,42.69,18.04
桃園市,龜山區,大坑里,727,318,409,5,732,1975,37.06,16.1
桃園市,龜山區,中興里,1796,890,906,15,1811,4708,38.47,18.9
桃園市,龜山區,山德里,1974,936,1038,26,2000,4790,41.75,19.54
桃園市,龜山區,新路里,2286,1102,1184,27,2313,5265,43.93,20.93
桃園市,龜山區,嶺頂里,1512,685,827,14,1526,4034,37.83,16.98
桃園市,龜山區,龍壽里,693,219,474,4,697,1760,39.6,12.44
桃園市,龜山區,舊路里,1143,565,578,18,1161,2636,44.04,21.43
桃園市,龜山區,大崗里,1403,663,740,13,1416,4111,34.44,16.13
桃園市,龜山區,文化里,2732,1319,1413,19,2751,6959,39.53,18.95
桃園市,龜山區,南美里,910,429,481,8,918,2303,39.86,18.63
桃園市,龜山區,幸福里,1690,876,814,17,1707,5268,32.4,16.63
桃園市,龜山區,福源里,784,397,387,8,792,1960,40.41,20.26
桃園市,龜山區,龍華里,1329,593,736,20,1349,3423,39.41,17.32
桃園市,龜山區,迴龍里,2343,1168,1175,30,2373,6098,38.91,19.15
桃園市,龜山區,新嶺里,1407,703,704,10,1417,3965,35.74,17.73
桃園市,龜山區,大湖里,2043,1050,993,13,2056,5410,38.0,19.41
桃園市,龜山區,大華里,3524,1717,1807,29,3553,8945,39.72,19.2
桃園市,龜山區,長庚里,1768,807,961,10,1778,4161,42.73,19.39
桃園市,龜山區,新興里,930,598,332,12,942,3071,30.67,19.47
桃園市,龜山區,文青里,3129,1769,1360,20,3149,7571,41.59,23.37
桃園市,龜山區,楓福里,1371,707,664,11,1382,3109,44.45,22.74
桃園市,八德區,興仁里,2935,1605,1330,25,2960,9275,31.91,17.3
桃園市,八德區,福興里,3364,1785,1579,27,3391,9960,34.05,17.92
桃園市,八德區,瑞豐里,1668,929,739,10,1678,4926,34.06,18.86
桃園市,八德區,瑞發里,1321,669,652,32,1353,3178,42.57,21.05
桃園市,八德區,瑞德里,1343,845,498,25,1368,3521,38.85,24.0
桃園市,八德區,瑞祥里,1304,903,401,17,1321,3201,41.27,28.21
桃園市,八德區,廣興里,1261,595,666,15,1276,3233,39.47,18.4
桃園市,八德區,廣隆里,1936,1068,868,29,1965,4536,43.32,23.54
桃園市,八德區,竹園里,1255,643,612,13,1268,3596,35.26,17.88
桃園市,八德區,霄裡里,826,386,440,10,836,2214,37.76,17.43
桃園市,八德區,茄苳里,924,409,515,7,931,2537,36.7,16.12
桃園市,八德區,高明里,1492,712,780,12,1504,3852,39.04,18.48
桃園市,八德區,白鷺里,1262,576,686,14,1276,3101,41.15,18.57
桃園市,八德區,大湳里,1473,652,821,10,1483,3930,37.74,16.59
桃園市,八德區,大安里,1371,632,739,16,1387,3486,39.79,18.13
桃園市,八德區,大興里,1515,783,732,9,1524,3792,40.19,20.65
桃園市,八德區,大和里,3006,1846,1160,31,3037,7352,41.31,25.11
桃園市,八德區,大同里,660,291,369,5,665,1505,44.19,19.34
桃園市,八德區,大成里,1426,680,746,11,1437,3312,43.39,20.53
桃園市,八德區,大義里,1451,834,617,14,1465,3738,39.19,22.31
桃園市,八德區,大忠里,712,397,315,8,720,1789,40.25,22.19
桃園市,八德區,大福里,2322,1238,1084,14,2336,5181,45.09,23.9
桃園市,八德區,大勇里,1691,872,819,11,1702,4113,41.38,21.2
桃園市,八德區,大信里,1278,723,555,21,1299,3515,36.96,20.57
桃園市,八德區,大華里,1060,576,484,10,1070,2531,42.28,22.76
桃園市,八德區,大仁里,1752,824,928,12,1764,4188,42.12,19.68
桃園市,八德區,大智里,1792,1123,669,13,1805,4256,42.41,26.39
桃園市,八德區,瑞泰里,1576,801,775,13,1589,4161,38.19,19.25
桃園市,八德區,大昌里,1186,637,549,19,1205,2848,42.31,22.37
桃園市,八德區,大正里,1632,865,767,14,1646,4290,38.37,20.16
桃園市,八德區,大強里,1335,578,757,15,1350,3074,43.92,18.8
桃園市,八德區,大發里,802,372,430,14,816,2030,40.2,18.33
桃園市,八德區,大明里,1457,685,772,16,1473,3632,40.56,18.86
桃園市,八德區,大竹里,605,254,351,5,610,1474,41.38,17.23
桃園市,八德區,大慶里,554,268,286,8,562,1414,39.75,18.95
桃園市,八德區,大千里,846,504,342,7,853,2222,38.39,22.68
桃園市,八德區,大榮里,764,384,380,11,775,1947,39.8,19.72
桃園市,八德區,茄明里,1773,945,828,17,1790,4778,37.46,19.78
桃園市,八德區,高城里,1235,639,596,8,1243,3114,39.92,20.52
桃園市,八德區,瑞興里,1122,509,613,11,1133,2788,40.64,18.26
桃園市,八德區,大愛里,1066,601,465,14,1080,2512,42.99,23.93
桃園市,八德區,大宏里,1789,1025,764,9,1798,4144,43.39,24.73
桃園市,八德區,大漢里,1530,888,642,14,1544,3923,39.36,22.64
桃園市,八德區,廣德里,1200,591,609,12,1212,2667,45.44,22.16
桃園市,八德區,龍友里,950,743,207,13,963,2166,44.46,34.3
桃園市,八德區,陸光里,1723,1372,351,36,1759,4338,40.55,31.63
桃園市,八德區,永豐里,1064,507,557,12,1076,2762,38.96,18.36
桃園市,八德區,大順里,1011,533,478,9,1020,2525,40.4,21.11
桃園市,龍潭區,黃唐里,1693,967,726,11,1704,4655,36.61,20.77
桃園市,龍潭區,中山里,2281,1290,991,34,2315,5884,39.34,21.92
桃園市,龍潭區,烏林里,1589,942,647,14,1603,4416,36.3,21.33
桃園市,龍潭區,高平里,1196,608,588,8,1204,3205,37.57,18.97
桃園市,龍潭區,凌雲里,1325,757,568,9,1334,3744,35.63,20.22
桃園市,龍潭區,八德里,1578,867,711,11,1589,4226,37.6,20.52
桃園市,龍潭區,三水里,276,86,190,7,283,652,43.4,13.19
桃園市,龍潭區,上林里,1717,959,758,10,1727,4406,39.2,21.77
桃園市,龍潭區,中正里,2155,1392,763,8,2163,5430,39.83,25.64
桃園市,龍潭區,龍潭里,837,437,400,5,842,1835,45.89,23.81
桃園市,龍潭區,高原里,1621,833,788,22,1643,4539,36.2,18.35
桃園市,龍潭區,九龍里,1440,873,567,11,1451,3741,38.79,23.34
桃園市,龍潭區,中興里,1569,986,583,15,1584,4232,37.43,23.3
桃園市,龍潭區,佳安里,1562,1058,504,21,1583,3420,46.29,30.94
桃園市,龍潭區,三和里,1187,741,446,7,1194,2574,46.39,28.79
桃園市,龍潭區,三坑里,607,276,331,7,614,1466,41.88,18.83
桃園市,龍潭區,大平里,1036,575,461,4,1040,2332,44.6,24.66
桃園市,龍潭區,三林里,1447,952,495,12,1459,3072,47.49,30.99
桃園市,龍潭區,永興里,1075,597,478,16,1091,2825,38.62,21.13
桃園市,龍潭區,烏樹林里,1011,522,489,8,1019,2613,39.0,19.98
桃園市,龍潭區,百年里,1965,1400,565,16,1981,4262,46.48,32.85
桃園市,龍潭區,龍祥里,1279,794,485,13,1292,3487,37.05,22.77
桃園市,龍潭區,聖德里,1138,559,579,7,1145,2995,38.23,18.66
桃園市,龍潭區,龍星里,1830,1080,750,21,1851,4094,45.21,26.38
桃園市,龍潭區,上華里,1389,900,489,10,1399,3238,43.21,27.79
桃園市,龍潭區,武漢里,555,340,215,7,562,1491,37.69,22.8
桃園市,龍潭區,東興里,1470,1007,463,15,1485,3992,37.2,25.23
桃園市,龍潭區,北興里,766,499,267,15,781,2314,33.75,21.56
桃園市,龍潭區,建林里,1785,1268,517,8,1793,3664,48.94,34.61
桃園市,龍潭區,富林里,1438,968,470,15,1453,3448,42.14,28.07
桃園市,龍潭區,祥和里,478,232,246,10,488,1583,30.83,14.66
桃園市,平鎮區,雙連里,1806,974,832,18,1824,4741,38.47,20.54
桃園市,平鎮區,高雙里,1905,942,963,14,1919,4288,44.75,21.97
桃園市,平鎮區,復旦里,2286,1348,938,15,2301,5412,42.52,24.91
桃園市,平鎮區,廣興里,2514,1349,1165,17,2531,5467,46.3,24.68
桃園市,平鎮區,義民里,2055,1179,876,12,2067,5228,39.54,22.55
桃園市,平鎮區,宋屋里,1666,899,767,19,1685,4332,38.9,20.75
桃園市,平鎮區,新勢里,1582,843,739,13,1595,3659,43.59,23.04
桃園市,平鎮區,新富里,2358,1326,1032,32,2390,6520,36.66,20.34
桃園市,平鎮區,北勢里,1161,583,578,9,1170,2424,48.27,24.05
桃園市,平鎮區,北興里,1576,800,776,12,1588,3911,40.6,20.46
桃園市,平鎮區,北貴里,1697,892,805,16,1713,3974,43.11,22.45
桃園市,平鎮區,平鎮里,1670,880,790,18,1688,4457,37.87,19.74
桃園市,平鎮區,南勢里,2261,1239,1022,18,2279,5771,39.49,21.47
桃園市,平鎮區,莊敬里,1895,1188,707,28,1923,4674,41.14,25.42
桃園市,平鎮區,山峰里,907,558,349,8,915,2330,39.27,23.95
桃園市,平鎮區,湧光里,2112,1217,895,24,2136,5189,41.16,23.45
桃園市,平鎮區,龍恩里,1115,738,377,14,1129,2791,40.45,26.44
桃園市,平鎮區,東社里,1304,869,435,12,1316,3322,39.61,26.16
桃園市,平鎮區,龍興里,1066,780,286,16,1082,2548,42.46,30.61
桃園市,平鎮區,貿易里,919,632,287,9,928,1945,47.71,32.49
桃園市,平鎮區,忠貞里,600,442,158,5,605,1318,45.9,33.54
桃園市,平鎮區,中正里,702,530,172,12,714,1650,43.27,32.12
桃園市,平鎮區,建安里,1724,880,844,13,1737,4292,40.47,20.5
桃園市,平鎮區,東勢里,2062,993,1069,13,2075,5410,38.35,18.35
桃園市,平鎮區,東安里,1013,669,344,10,1023,2812,36.38,23.79
桃園市,平鎮區,新安里,1591,949,642,25,1616,4358,37.08,21.78
桃園市,平鎮區,鎮興里,1200,566,634,15,1215,3084,39.4,18.35
桃園市,平鎮區,義興里,2956,1558,1398,19,2975,6850,43.43,22.74
桃園市,平鎮區,湧豐里,710,399,311,10,720,1755,41.03,22.74
桃園市,平鎮區,湧安里,1539,922,617,17,1556,4511,34.49,20.44
桃園市,平鎮區,廣達里,1705,824,881,14,1719,3871,44.41,21.29
桃園市,平鎮區,福林里,1437,769,668,12,1449,3429,42.26,22.43
桃園市,平鎮區,金星里,2437,1409,1028,22,2459,6586,37.34,21.39
桃園市,平鎮區,廣仁里,1530,820,710,11,1541,4222,36.5,19.42
桃園市,平鎮區,新貴里,1366,687,679,14,1380,3064,45.04,22.42
桃園市,平鎮區,北富里,1673,869,804,9,1682,3878,43.37,22.41
桃園市,平鎮區,新榮里,2244,1237,1007,24,2268,5110,44.38,24.21
桃園市,平鎮區,華安里,1516,1009,507,20,1536,4282,35.87,23.56
桃園市,平鎮區,金陵里,1262,712,550,12,1274,2823,45.13,25.22
桃園市,平鎮區,北安里,732,350,382,4,736,1551,47.45,22.57
桃園市,平鎮區,北華里,1728,1027,701,8,1736,3758,46.19,27.33
桃園市,平鎮區,復興里,2197,1197,1000,20,2217,4904,45.21,24.41
桃園市,平鎮區,平興里,2184,1278,906,13,2197,5498,39.96,23.24
桃園市,平鎮區,新英里,1599,975,624,14,1613,3806,42.38,25.62
桃園市,平鎮區,平安里,2024,1063,961,23,2047,5085,40.26,20.9
桃園市,平鎮區,平南里,2621,1464,1157,20,2641,6707,39.38,21.83
桃園市,新屋區,新屋里,1143,575,568,5,1148,2883,39.82,19.94
桃園市,新屋區,新生里,1561,842,719,10,1571,3991,39.36,21.1
桃園市,新屋區,後湖里,536,259,277,7,543,1517,35.79,17.07
桃園市,新屋區,清華里,1456,742,714,4,1460,4096,35.64,18.12
桃園市,新屋區,頭洲里,1724,855,869,12,1736,4467,38.86,19.14
桃園市,新屋區,埔頂里,885,440,445,6,891,2563,34.76,17.17
桃園市,新屋區,九斗里,889,400,489,10,899,2292,39.22,17.45
桃園市,新屋區,社子里,534,234,300,6,540,1356,39.82,17.26
桃園市,新屋區,東明里,570,268,302,7,577,1466,39.36,18.28
桃園市,新屋區,石磊里,811,346,465,14,825,2076,39.74,16.67
桃園市,新屋區,下埔里,308,146,162,2,310,730,42.47,20.0
桃園市,新屋區,下田里,631,317,314,5,636,1727,36.83,18.36
桃園市,新屋區,石牌里,382,208,174,6,388,926,41.9,22.46
桃園市,新屋區,赤欄里,493,240,253,7,500,1310,38.17,18.32
桃園市,新屋區,永興里,417,195,222,5,422,1021,41.33,19.1
桃園市,新屋區,永安里,901,456,445,9,910,2201,41.34,20.72
桃園市,新屋區,笨港里,411,223,188,6,417,1020,40.88,21.86
桃園市,新屋區,深圳里,245,115,130,0,245,639,38.34,18.0
桃園市,新屋區,蚵間里,336,118,218,2,338,900,37.56,13.11
桃園市,新屋區,槺榔里,413,182,231,6,419,1072,39.09,16.98
桃園市,新屋區,後庄里,451,232,219,4,455,1098,41.44,21.13
桃園市,新屋區,大坡里,478,203,275,3,481,1294,37.17,15.69
桃園市,新屋區,望間里,514,220,294,3,517,1391,37.17,15.82
桃園市,觀音區,觀音里,996,489,507,7,1003,2767,36.25,17.67
桃園市,觀音區,白玉里,373,191,182,2,375,875,42.86,21.83
桃園市,觀音區,廣興里,484,248,236,7,491,1310,37.48,18.93
桃園市,觀音區,大潭里,804,281,523,8,812,1899,42.76,14.8
桃園市,觀音區,武威里,379,175,204,1,380,912,41.67,19.19
桃園市,觀音區,保生里,814,373,441,8,822,2180,37.71,17.11
桃園市,觀音區,三和里,370,189,181,5,375,854,43.91,22.13
桃園市,觀音區,新興里,298,140,158,2,300,705,42.55,19.86
桃園市,觀音區,坑尾里,608,279,329,3,611,1831,33.37,15.24
桃園市,觀音區,金湖里,926,437,489,9,935,2633,35.51,16.6
桃園市,觀音區,藍埔里,1046,454,592,6,1052,2621,40.14,17.32
桃園市,觀音區,大同里,1199,492,707,10,1209,3116,38.8,15.79
桃園市,觀音區,大堀里,541,210,331,7,548,1484,36.93,14.15
桃園市,觀音區,崙坪里,1918,740,1178,9,1927,4757,40.51,15.56
桃園市,觀音區,富源里,1479,737,742,12,1491,3918,38.06,18.81
桃園市,觀音區,上大里,969,437,532,13,982,2458,39.95,17.78
桃園市,觀音區,新坡里,1133,481,652,5,1138,2971,38.3,16.19
桃園市,觀音區,廣福里,920,377,543,10,930,2482,37.47,15.19
桃園市,觀音區,塔腳里,340,150,190,5,345,1021,33.79,14.69
桃園市,觀音區,保障里,776,283,493,7,783,1950,40.15,14.51
桃園市,觀音區,草漯里,981,510,471,12,993,2935,33.83,17.38
桃園市,觀音區,樹林里,1239,595,644,15,1254,4468,28.07,13.32
桃園市,觀音區,富林里,653,290,363,5,658,1926,34.16,15.06
桃園市,觀音區,草新里,1887,951,936,15,1902,5720,33.25,16.63
桃園市,復興區,三民里,666,348,318,15,681,2041,33.37,17.05
桃園市,復興區,澤仁里,434,306,128,5,439,1426,30.79,21.46
桃園市,復興區,義盛里,219,186,33,4,223,745,29.93,24.97
桃園市,復興區,霞雲里,163,135,28,2,165,631,26.15,21.39
桃園市,復興區,長興里,154,117,37,6,160,660,24.24,17.73
桃園市,復興區,三光里,126,110,16,4,130,683,19.03,16.11
桃園市,復興區,奎輝里,205,167,38,1,206,764,26.96,21.86
桃園市,復興區,華陵里,289,171,118,1,290,1265,22.92,13.52
桃園市,復興區,羅浮里,334,245,89,3,337,1067,31.58,22.96
桃園市,復興區,高義里,122,91,31,1,123,754,16.31,12.07
臺中市,中區,繼光里,641,265,376,6,647,1436,45.06,18.45
臺中市,中區,大墩里,823,382,441,5,828,1946,42.55,19.63
臺中市,中區,綠川里,681,295,386,6,687,1572,43.7,18.77
臺中市,中區,公園里,577,268,309,6,583,1353,43.09,19.81
臺中市,中區,光復里,841,417,424,11,852,1913,44.54,21.8
臺中市,中區,柳川里,704,331,373,10,714,1884,37.9,17.57
臺中市,中區,大誠里,994,436,558,9,1003,2244,44.7,19.43
臺中市,中區,中華里,762,367,395,6,768,1847,41.58,19.87
臺中市,東區,新庄里,1167,525,642,9,1176,2974,39.54,17.65
臺中市,東區,振興里,1425,571,854,18,1443,3053,47.26,18.7
臺中市,東區,東橋里,1694,627,1067,22,1716,3732,45.98,16.8
臺中市,東區,東興里,1242,530,712,16,1258,2791,45.07,18.99
臺中市,東區,干城里,913,434,479,9,922,1889,48.81,22.98
臺中市,東區,泉源里,927,399,528,9,936,2030,46.11,19.66
臺中市,東區,旱溪里,1178,504,674,11,1189,2499,47.58,20.17
臺中市,東區,樂成里,964,399,565,10,974,2244,43.4,17.78
臺中市,東區,東門里,3027,1210,1817,35,3062,6693,45.75,18.08
臺中市,東區,十甲里,2090,976,1114,15,2105,4732,44.48,20.63
臺中市,東區,東南里,1645,859,786,15,1660,3682,45.08,23.33
臺中市,東區,東勢里,1078,566,512,11,1089,2651,41.08,21.35
臺中市,東區,合作里,1676,1061,615,13,1689,3985,42.38,26.62
臺中市,東區,富台里,761,498,263,6,767,1703,45.04,29.24
臺中市,東區,富仁里,1836,1242,594,21,1857,4044,45.92,30.71
臺中市,東區,東信里,3981,1694,2287,54,4035,8763,46.05,19.33
臺中市,東區,東英里,3203,1448,1755,26,3229,7152,45.15,20.25
臺中市,南區,城隍里,1607,733,874,12,1619,3502,46.23,20.93
臺中市,南區,國光里,1676,740,936,20,1696,3745,45.29,19.76
臺中市,南區,南門里,1621,760,861,19,1640,3412,48.07,22.27
臺中市,南區,德義里,1345,673,672,17,1362,2840,47.96,23.7
臺中市,南區,積善里,1146,511,635,12,1158,2506,46.21,20.39
臺中市,南區,江川里,1328,653,675,14,1342,2714,49.45,24.06
臺中市,南區,新榮里,1897,1005,892,17,1914,4415,43.35,22.76
臺中市,南區,福興里,1821,871,950,9,1830,3817,47.94,22.82
臺中市,南區,福平里,2311,1107,1204,22,2333,5297,44.04,20.9
臺中市,南區,和平里,1555,763,792,13,1568,4091,38.33,18.65
臺中市,南區,永興里,3515,1809,1706,24,3539,7871,44.96,22.98
臺中市,南區,樹義里,5050,2473,2577,37,5087,11718,43.41,21.1
臺中市,南區,樹德里,3751,1945,1806,36,3787,8372,45.23,23.23
臺中市,南區,西川里,1904,1004,900,19,1923,4215,45.62,23.82
臺中市,南區,長春里,894,418,476,11,905,1865,48.53,22.41
臺中市,南區,長榮里,1155,535,620,19,1174,2394,49.04,22.35
臺中市,南區,福順里,2414,1202,1212,22,2436,5566,43.77,21.6
臺中市,南區,平和里,1503,676,827,19,1522,3459,44.0,19.54
臺中市,南區,南和里,2978,1586,1392,27,3005,7374,40.75,21.51
臺中市,南區,永和里,1949,971,978,13,1962,4610,42.56,21.06
臺中市,南區,工學里,2843,1444,1399,21,2864,6608,43.34,21.85
臺中市,南區,崇倫里,2442,1175,1267,22,2464,5361,45.96,21.92
臺中市,西區,民生里,799,404,395,7,806,1694,47.58,23.85
臺中市,西區,利民里,620,351,269,10,630,1340,47.01,26.19
臺中市,西區,三民里,803,407,396,3,806,2306,34.95,17.65
臺中市,西區,東昇里,1101,547,554,6,1107,2250,49.2,24.31
臺中市,西區,廣民里,611,308,303,2,613,1370,44.74,22.48
臺中市,西區,平和里,808,430,378,4,812,1840,44.13,23.37
臺中市,西區,公民里,2251,1075,1176,16,2267,4767,47.56,22.55
臺中市,西區,藍興里,1843,924,919,22,1865,3884,48.02,23.79
臺中市,西區,公舘里,2513,1170,1343,20,2533,5582,45.38,20.96
臺中市,西區,和龍里,990,419,571,7,997,2244,44.43,18.67
臺中市,西區,民龍里,1511,781,730,15,1526,3397,44.92,22.99
臺中市,西區,後龍里,1486,713,773,14,1500,3447,43.52,20.68
臺中市,西區,安龍里,1367,654,713,17,1384,2776,49.86,23.56
臺中市,西區,吉龍里,2960,1530,1430,22,2982,6405,46.56,23.89
臺中市,西區,昇平里,2503,1175,1328,24,2527,5634,44.85,20.86
臺中市,西區,忠明里,2678,1243,1435,21,2699,5653,47.74,21.99
臺中市,西區,公正里,2911,1416,1495,31,2942,6172,47.67,22.94
臺中市,西區,土庫里,2568,1189,1379,22,2590,5619,46.09,21.16
臺中市,西區,忠誠里,2477,1183,1294,20,2497,5548,45.01,21.32
臺中市,西區,公益里,1261,545,716,14,1275,2725,46.79,20.0
臺中市,西區,中興里,1717,738,979,9,1726,3518,49.06,20.98
臺中市,西區,公平里,2111,1119,992,22,2133,4905,43.49,22.81
臺中市,西區,公德里,1870,947,923,13,1883,4170,45.16,22.71
臺中市,西區,双龍里,1239,633,606,11,1250,2712,46.09,23.34
臺中市,西區,大忠里,2120,1084,1036,23,2143,4315,49.66,25.12
臺中市,北區,光大里,838,383,455,13,851,2049,41.53,18.69
臺中市,北區,文莊里,1613,1021,592,24,1637,3331,49.14,30.65
臺中市,北區,五常里,562,238,324,7,569,1343,42.37,17.72
臺中市,北區,新興里,617,348,269,4,621,1453,42.74,23.95
臺中市,北區,新北里,776,363,413,5,781,1655,47.19,21.93
臺中市,北區,樂英里,1151,891,260,11,1162,2490,46.67,35.78
臺中市,北區,錦村里,1509,797,712,5,1514,3071,49.3,25.95
臺中市,北區,建成里,2293,1109,1184,19,2312,5570,41.51,19.91
臺中市,北區,錦洲里,1451,797,654,17,1468,3236,45.36,24.63
臺中市,北區,金華里,1173,623,550,9,1182,2501,47.26,24.91
臺中市,北區,金龍里,1847,977,870,12,1859,4247,43.77,23.0
臺中市,北區,邱厝里,993,513,480,7,1000,2256,44.33,22.74
臺中市,北區,建興里,2451,1170,1281,22,2473,5454,45.34,21.45
臺中市,北區,頂厝里,1861,991,870,22,1883,4109,45.83,24.12
臺中市,北區,賴厝里,1711,977,734,15,1726,5017,34.4,19.47
臺中市,北區,賴村里,1921,877,1044,19,1940,4300,45.12,20.4
臺中市,北區,育德里,1660,833,827,9,1669,3585,46.56,23.24
臺中市,北區,淡溝里,2250,1092,1158,30,2280,5018,45.44,21.76
臺中市,北區,中達里,1137,555,582,12,1149,2573,44.66,21.57
臺中市,北區,錦祥里,1964,1081,883,13,1977,4459,44.34,24.24
臺中市,北區,健行里,3055,1425,1630,28,3083,6438,47.89,22.13
臺中市,北區,明德里,2320,1152,1168,16,2336,5217,44.78,22.08
臺中市,北區,長青里,2565,1274,1291,24,2589,5993,43.2,21.26
臺中市,北區,賴明里,1576,850,726,10,1586,3763,42.15,22.59
臺中市,北區,賴興里,1644,929,715,11,1655,3730,44.37,24.91
臺中市,北區,中正里,572,210,362,6,578,1309,44.16,16.04
臺中市,北區,六合里,678,250,428,1,679,1727,39.32,14.48
臺中市,北區,大湖里,819,335,484,7,826,2153,38.37,15.56
臺中市,北區,錦平里,775,366,409,8,783,1840,42.55,19.89
臺中市,北區,建德里,1553,813,740,20,1573,3229,48.71,25.18
臺中市,北區,崇德里,1443,728,715,12,1455,3417,42.58,21.31
臺中市,北區,賴旺里,1655,866,789,12,1667,4259,39.14,20.33
臺中市,北區,明新里,1165,606,559,13,1178,2661,44.27,22.77
臺中市,北區,立人里,1548,856,692,13,1561,3755,41.57,22.8
臺中市,北區,梅川里,1397,718,679,9,1406,3190,44.08,22.51
臺中市,北區,賴福里,1834,940,894,16,1850,3762,49.18,24.99
臺中市,西屯區,西安里,2262,1101,1161,16,2278,5165,44.1,21.32
臺中市,西屯區,西墩里,2436,1143,1293,12,2448,5884,41.6,19.43
臺中市,西屯區,潮洋里,2270,1094,1176,26,2296,6268,36.63,17.45
臺中市,西屯區,龍潭里,409,160,249,7,416,833,49.94,19.21
臺中市,西屯區,惠來里,6197,3243,2954,66,6263,14638,42.79,22.15
臺中市,西屯區,上石里,1969,1046,923,24,1993,5016,39.73,20.85
臺中市,西屯區,逢甲里,1748,903,845,13,1761,4314,40.82,20.93
臺中市,西屯區,鵬程里,1243,1072,171,14,1257,2619,48.0,40.93
臺中市,西屯區,何安里,2196,1049,1147,20,2216,5075,43.67,20.67
臺中市,西屯區,何厝里,1351,636,715,10,1361,3200,42.53,19.88
臺中市,西屯區,大河里,1800,775,1025,15,1815,3726,48.71,20.8
臺中市,西屯區,大石里,1019,866,153,22,1041,2082,50.0,41.59
臺中市,西屯區,大福里,1358,772,586,15,1373,3255,42.18,23.72
臺中市,西屯區,大鵬里,1999,1121,878,7,2006,4745,42.28,23.62
臺中市,西屯區,港尾里,2114,1026,1088,29,2143,4944,43.35,20.75
臺中市,西屯區,廣福里,1044,443,601,8,1052,2324,45.27,19.06
臺中市,西屯區,林厝里,1430,734,696,12,1442,3398,42.44,21.6
臺中市,西屯區,永安里,4979,2594,2385,52,5031,12696,39.63,20.43
臺中市,西屯區,福安里,1343,691,652,20,1363,2940,46.36,23.5
臺中市,西屯區,協和里,1934,871,1063,15,1949,4642,41.99,18.76
臺中市,西屯區,何仁里,2645,1266,1379,31,2676,6083,43.99,20.81
臺中市,西屯區,何德里,1570,778,792,15,1585,3633,43.63,21.41
臺中市,西屯區,何源里,2864,1511,1353,30,2894,6639,43.59,22.76
臺中市,西屯區,西平里,1955,1151,804,24,1979,4807,41.17,23.94
臺中市,西屯區,何南里,1962,1027,935,19,1981,4097,48.35,25.07
臺中市,西屯區,至善里,1904,1036,868,23,1927,4381,43.99,23.65
臺中市,西屯區,上安里,2294,1191,1103,33,2327,5223,44.55,22.8
臺中市,西屯區,上德里,1864,1030,834,22,1886,4120,45.78,25.0
臺中市,西屯區,逢福里,2427,1314,1113,23,2450,5257,46.6,25.0
臺中市,西屯區,何明里,1689,820,869,8,1697,3558,47.7,23.05
臺中市,西屯區,何成里,3058,1537,1521,32,3090,7080,43.64,21.71
臺中市,西屯區,何福里,1957,944,1013,17,1974,4322,45.67,21.84
臺中市,西屯區,福和里,1760,703,1057,18,1778,4278,41.56,16.43
臺中市,西屯區,福中里,1381,657,724,8,1389,3203,43.37,20.51
臺中市,西屯區,福恩里,2241,1203,1038,28,2269,4778,47.49,25.18
臺中市,西屯區,福聯里,1113,591,522,17,1130,3166,35.69,18.67
臺中市,西屯區,福瑞里,1118,660,458,11,1129,2980,37.89,22.15
臺中市,西屯區,福林里,3358,1865,1493,38,3396,7655,44.36,24.36
臺中市,西屯區,福雅里,2454,1326,1128,25,2479,5769,42.97,22.98
臺中市,南屯區,南屯里,3775,1822,1953,46,3821,8528,44.81,21.36
臺中市,南屯區,豐樂里,5219,2501,2718,48,5267,11358,46.37,22.02
臺中市,南屯區,楓樹里,2802,1288,1514,34,2836,5891,48.14,21.86
臺中市,南屯區,中和里,1858,775,1083,18,1876,4324,43.39,17.92
臺中市,南屯區,春社里,2458,1285,1173,27,2485,6534,38.03,19.67
臺中市,南屯區,春安里,492,248,244,5,497,1366,36.38,18.16
臺中市,南屯區,文山里,4270,1999,2271,36,4306,11272,38.2,17.73
臺中市,南屯區,新生里,918,426,492,1,919,2301,39.94,18.51
臺中市,南屯區,永定里,2132,946,1186,24,2156,5105,42.23,18.53
臺中市,南屯區,三厝里,2976,1526,1450,36,3012,7137,42.2,21.38
臺中市,南屯區,溝墘里,2627,1339,1288,23,2650,5220,50.77,25.65
臺中市,南屯區,田心里,2758,1285,1473,28,2786,6268,44.45,20.5
臺中市,南屯區,黎明里,1958,1141,817,13,1971,4151,47.48,27.49
臺中市,南屯區,鎮平里,580,214,366,9,589,1357,43.4,15.77
臺中市,南屯區,大同里,2273,1086,1187,13,2286,4877,46.87,22.27
臺中市,南屯區,文心里,1720,880,840,27,1747,3803,45.94,23.14
臺中市,南屯區,同心里,2230,1116,1114,36,2266,5223,43.39,21.37
臺中市,南屯區,向心里,2160,1082,1078,21,2181,5433,40.14,19.92
臺中市,南屯區,大誠里,1645,810,835,11,1656,3609,45.89,22.44
臺中市,南屯區,大興里,1992,956,1036,19,2011,4436,45.33,21.55
臺中市,南屯區,大業里,3017,1529,1488,20,3037,6517,46.6,23.46
臺中市,南屯區,惠中里,3379,1730,1649,29,3408,7565,45.05,22.87
臺中市,南屯區,寶山里,2059,1014,1045,15,2074,5266,39.38,19.26
臺中市,南屯區,三和里,3779,2095,1684,42,3821,8478,45.07,24.71
臺中市,南屯區,三義里,2899,1607,1292,29,2928,6493,45.09,24.75
臺中市,北屯區,北興里,1428,735,693,14,1442,3133,46.03,23.46
臺中市,北屯區,北屯里,1476,824,652,5,1481,3392,43.66,24.29
臺中市,北屯區,三光里,3040,1654,1386,25,3065,6954,44.08,23.78
臺中市,北屯區,平田里,2398,1269,1129,18,2416,5705,42.35,22.24
臺中市,北屯區,平和里,2092,1170,922,14,2106,5097,41.32,22.95
臺中市,北屯區,東光里,1937,985,952,22,1959,4595,42.63,21.44
臺中市,北屯區,舊社里,2930,1457,1473,23,2953,7211,40.95,20.21
臺中市,北屯區,水景里,5903,2882,3021,49,5952,13462,44.21,21.41
臺中市,北屯區,軍功里,5435,2611,2824,55,5490,12347,44.46,21.15
臺中市,北屯區,和平里,4750,2324,2426,32,4782,11410,41.91,20.37
臺中市,北屯區,東山里,919,371,548,9,928,2030,45.71,18.28
臺中市,北屯區,民政里,373,175,198,4,377,1008,37.4,17.36
臺中市,北屯區,廍子里,5450,2822,2628,42,5492,14177,38.74,19.91
臺中市,北屯區,大坑里,906,434,472,12,918,2160,42.5,20.09
臺中市,北屯區,民德里,358,167,191,1,359,905,39.67,18.45
臺中市,北屯區,松竹里,3857,2132,1725,44,3901,8784,44.41,24.27
臺中市,北屯區,仁和里,3503,1777,1726,30,3533,9231,38.27,19.25
臺中市,北屯區,仁美里,3996,1980,2016,19,4015,9374,42.83,21.12
臺中市,北屯區,四民里,690,343,347,7,697,1525,45.7,22.49
臺中市,北屯區,后庄里,4319,2552,1767,38,4357,9850,44.23,25.91
臺中市,北屯區,同榮里,2399,1263,1136,22,2421,5327,45.45,23.71
臺中市,北屯區,仁愛里,476,280,196,6,482,1046,46.08,26.77
臺中市,北屯區,水湳里,2963,1496,1467,39,3002,6614,45.39,22.62
臺中市,北屯區,陳平里,1924,1090,834,20,1944,4564,42.59,23.88
臺中市,北屯區,新平里,1742,1012,730,15,1757,4248,41.36,23.82
臺中市,北屯區,平安里,2356,1159,1197,21,2377,5130,46.34,22.59
臺中市,北屯區,平順里,1395,683,712,9,1404,3146,44.63,21.71
臺中市,北屯區,平德里,2608,1350,1258,19,2627,6176,42.54,21.86
臺中市,北屯區,松安里,2067,1044,1023,12,2079,4780,43.49,21.84
臺中市,北屯區,松茂里,2249,1251,998,21,2270,5241,43.31,23.87
臺中市,北屯區,大德里,2255,1297,958,21,2276,4863,46.8,26.67
臺中市,北屯區,松強里,2722,1401,1321,19,2741,6705,40.88,20.89
臺中市,北屯區,松勇里,2244,1200,1044,26,2270,5153,44.05,23.29
臺中市,北屯區,北京里,1450,695,755,17,1467,3180,46.13,21.86
臺中市,北屯區,平心里,2014,1064,950,13,2027,4765,42.54,22.33
臺中市,北屯區,平福里,1596,883,713,16,1612,3560,45.28,24.8
臺中市,北屯區,松和里,2476,1304,1172,18,2494,6410,38.91,20.34
臺中市,北屯區,平陽里,2063,1094,969,19,2082,4887,42.6,22.39
臺中市,北屯區,平興里,2717,1428,1289,28,2745,6741,40.72,21.18
臺中市,北屯區,平昌里,1870,964,906,20,1890,4376,43.19,22.03
臺中市,北屯區,三和里,2483,1372,1111,20,2503,5662,44.21,24.23
臺中市,北屯區,忠平里,1704,1008,696,13,1717,3906,43.96,25.81
臺中市,豐原區,豐原里,980,519,461,19,999,2243,44.54,23.14
臺中市,豐原區,頂街里,420,160,260,3,423,919,46.03,17.41
臺中市,豐原區,中山里,403,174,229,3,406,795,51.07,21.89
臺中市,豐原區,豐榮里,518,217,301,3,521,1106,47.11,19.62
臺中市,豐原區,下街里,298,119,179,3,301,744,40.46,15.99
臺中市,豐原區,富春里,385,168,217,3,388,720,53.89,23.33
臺中市,豐原區,葫蘆里,300,125,175,3,303,607,49.92,20.59
臺中市,豐原區,豐西里,755,363,392,5,760,1595,47.65,22.76
臺中市,豐原區,西安里,2178,1001,1177,17,2195,4781,45.91,20.94
臺中市,豐原區,西勢里,1043,461,582,13,1056,2152,49.07,21.42
臺中市,豐原區,東勢里,663,302,361,7,670,1433,46.76,21.07
臺中市,豐原區,民生里,467,178,289,5,472,1119,42.18,15.91
臺中市,豐原區,大湳里,1101,467,634,4,1105,2494,44.31,18.72
臺中市,豐原區,北湳里,1280,661,619,19,1299,2882,45.07,22.94
臺中市,豐原區,東湳里,1661,640,1021,15,1676,3976,42.15,16.1
臺中市,豐原區,西湳里,3836,1631,2205,39,3875,9125,42.47,17.87
臺中市,豐原區,圳寮里,593,248,345,7,600,1231,48.74,20.15
臺中市,豐原區,豐圳里,1497,713,784,11,1508,3367,44.79,21.18
臺中市,豐原區,社皮里,3877,1841,2036,53,3930,9864,39.84,18.66
臺中市,豐原區,三村里,2788,1258,1530,29,2817,6283,44.84,20.02
臺中市,豐原區,中興里,1236,688,548,14,1250,2877,43.45,23.91
臺中市,豐原區,田心里,2488,1143,1345,22,2510,6296,39.87,18.15
臺中市,豐原區,豐田里,4246,1854,2392,46,4292,10193,42.11,18.19
臺中市,豐原區,鎌村里,1996,918,1078,25,2021,4633,43.62,19.81
臺中市,豐原區,南陽里,4394,2080,2314,31,4425,10538,41.99,19.74
臺中市,豐原區,陽明里,1164,559,605,11,1175,2631,44.66,21.25
臺中市,豐原區,北陽里,5433,2579,2854,48,5481,12989,42.2,19.86
臺中市,豐原區,中陽里,2260,1079,1181,16,2276,5045,45.11,21.39
臺中市,豐原區,東陽里,728,293,435,9,737,1574,46.82,18.61
臺中市,豐原區,南村里,2314,996,1318,28,2342,5234,44.75,19.03
臺中市,豐原區,南田里,1392,575,817,16,1408,3175,44.35,18.11
臺中市,豐原區,南嵩里,1437,599,838,20,1457,3377,43.14,17.74
臺中市,豐原區,翁明里,970,493,477,15,985,2265,43.49,21.77
臺中市,豐原區,翁子里,1325,636,689,17,1342,3221,41.66,19.75
臺中市,豐原區,翁社里,952,407,545,13,965,2049,47.1,19.86
臺中市,豐原區,朴子里,1356,515,841,13,1369,3287,41.65,15.67
臺中市,東勢區,北興里,491,313,178,9,500,1297,38.55,24.13
臺中市,東勢區,中寧里,364,235,129,7,371,833,44.54,28.21
臺中市,東勢區,東安里,431,255,176,2,433,996,43.47,25.6
臺中市,東勢區,南平里,805,537,268,7,812,1754,46.29,30.62
臺中市,東勢區,延平里,910,503,407,7,917,2138,42.89,23.53
臺中市,東勢區,上新里,423,267,156,2,425,951,44.69,28.08
臺中市,東勢區,廣興里,571,336,235,8,579,1403,41.27,23.95
臺中市,東勢區,泰昌里,1447,903,544,14,1461,3402,42.95,26.54
臺中市,東勢區,中嵙里,666,393,273,12,678,1835,36.95,21.42
臺中市,東勢區,福隆里,1451,846,605,30,1481,3709,39.93,22.81
臺中市,東勢區,隆興里,487,276,211,4,491,1418,34.63,19.46
臺中市,東勢區,新盛里,1894,989,905,14,1908,4812,39.65,20.55
臺中市,東勢區,詒福里,666,324,342,12,678,1616,41.96,20.05
臺中市,東勢區,上城里,427,227,200,10,437,963,45.38,23.57
臺中市,東勢區,下城里,360,175,185,12,372,832,44.71,21.03
臺中市,東勢區,慶東里,690,312,378,21,711,1825,38.96,17.1
臺中市,東勢區,慶福里,375,193,182,5,380,1233,30.82,15.65
臺中市,東勢區,東新里,855,535,320,11,866,1954,44.32,27.38
臺中市,東勢區,粵寧里,839,451,388,12,851,2023,42.07,22.29
臺中市,東勢區,下新里,649,332,317,18,667,1651,40.4,20.11
臺中市,東勢區,興隆里,455,201,254,5,460,1172,39.25,17.15
臺中市,東勢區,茂興里,621,341,280,6,627,1817,34.51,18.77
臺中市,東勢區,泰興里,226,121,105,2,228,701,32.52,17.26
臺中市,東勢區,埤頭里,285,111,174,6,291,657,44.29,16.89
臺中市,東勢區,明正里,456,202,254,14,470,1365,34.43,14.8
臺中市,大甲區,朝陽里,575,259,316,7,582,1331,43.73,19.46
臺中市,大甲區,大甲里,432,194,238,6,438,991,44.2,19.58
臺中市,大甲區,順天里,684,299,385,3,687,1532,44.84,19.52
臺中市,大甲區,孔門里,287,149,138,3,290,748,38.77,19.92
臺中市,大甲區,平安里,785,357,428,11,796,2008,39.64,17.78
臺中市,大甲區,庄美里,883,392,491,11,894,2055,43.5,19.08
臺中市,大甲區,新美里,1330,648,682,15,1345,3394,39.63,19.09
臺中市,大甲區,岷山里,771,374,397,7,778,2042,38.1,18.32
臺中市,大甲區,中山里,1711,893,818,24,1735,4515,38.43,19.78
臺中市,大甲區,南陽里,328,164,164,3,331,813,40.71,20.17
臺中市,大甲區,薰風里,397,170,227,5,402,860,46.74,19.77
臺中市,大甲區,義和里,1141,550,591,9,1150,3232,35.58,17.02
臺中市,大甲區,武陵里,453,235,218,3,456,1160,39.31,20.26
臺中市,大甲區,文曲里,354,126,228,2,356,1073,33.18,11.74
臺中市,大甲區,武曲里,701,333,368,4,705,1810,38.95,18.4
臺中市,大甲區,文武里,2068,1032,1036,20,2088,5206,40.11,19.82
臺中市,大甲區,奉化里,790,406,384,10,800,1996,40.08,20.34
臺中市,大甲區,德化里,634,267,367,4,638,1755,36.35,15.21
臺中市,大甲區,江南里,467,218,249,1,468,1356,34.51,16.08
臺中市,大甲區,頂店里,1671,777,894,15,1686,4450,37.89,17.46
臺中市,大甲區,太白里,428,181,247,9,437,1233,35.44,14.68
臺中市,大甲區,孟春里,1373,602,771,12,1385,3909,35.43,15.4
臺中市,大甲區,幸福里,854,360,494,10,864,2515,34.35,14.31
臺中市,大甲區,日南里,1807,882,925,21,1828,5476,33.38,16.11
臺中市,大甲區,龍泉里,573,267,306,10,583,1475,39.53,18.1
臺中市,大甲區,西岐里,589,283,306,12,601,1649,36.45,17.16
臺中市,大甲區,銅安里,434,196,238,7,441,1340,32.91,14.63
臺中市,大甲區,福德里,375,188,187,1,376,1111,33.84,16.92
臺中市,大甲區,建興里,437,184,253,7,444,1446,30.71,12.72
臺中市,清水區,鰲峰里,463,213,250,6,469,1063,44.12,20.04
臺中市,清水區,靈泉里,460,206,254,6,466,930,50.11,22.15
臺中市,清水區,清水里,915,405,510,6,921,2049,44.95,19.77
臺中市,清水區,文昌里,308,140,168,6,314,661,47.5,21.18
臺中市,清水區,南寧里,762,336,426,4,766,1743,43.95,19.28
臺中市,清水區,西寧里,657,275,382,6,663,1553,42.69,17.71
臺中市,清水區,北寧里,329,149,180,2,331,673,49.18,22.14
臺中市,清水區,中興里,207,90,117,4,211,391,53.96,23.02
臺中市,清水區,西社里,952,410,542,14,966,2191,44.09,18.71
臺中市,清水區,南社里,4112,1898,2214,31,4143,9925,41.74,19.12
臺中市,清水區,裕嘉里,539,236,303,5,544,1448,37.57,16.3
臺中市,清水區,臨江里,591,277,314,8,599,1505,39.8,18.41
臺中市,清水區,秀水里,1747,847,900,15,1762,4370,40.32,19.38
臺中市,清水區,武鹿里,1237,506,731,15,1252,3341,37.47,15.15
臺中市,清水區,海濱里,791,318,473,14,805,2104,38.26,15.11
臺中市,清水區,槺榔里,2292,974,1318,22,2314,6655,34.77,14.64
臺中市,清水區,中社里,1184,832,352,8,1192,2801,42.56,29.7
臺中市,清水區,高西里,396,226,170,6,402,1278,31.46,17.68
臺中市,清水區,高南里,445,194,251,6,451,1330,33.91,14.59
臺中市,清水區,高東里,410,176,234,9,419,1234,33.95,14.26
臺中市,清水區,高北里,335,151,184,2,337,1155,29.18,13.07
臺中市,清水區,高美里,447,221,226,5,452,1309,34.53,16.88
臺中市,清水區,國姓里,659,223,436,9,668,2039,32.76,10.94
臺中市,清水區,菁埔里,895,350,545,9,904,2252,40.14,15.54
臺中市,清水區,頂湳里,594,274,320,10,604,1765,34.22,15.52
臺中市,清水區,田寮里,809,294,515,9,818,2488,32.88,11.82
臺中市,清水區,橋頭里,2940,1191,1749,35,2975,7404,40.18,16.09
臺中市,清水區,下湳里,1066,467,599,11,1077,2764,38.97,16.9
臺中市,清水區,東山里,421,211,210,10,431,1197,36.01,17.63
臺中市,清水區,楊厝里,438,171,267,2,440,1156,38.06,14.79
臺中市,清水區,海風里,496,241,255,7,503,1390,36.19,17.34
臺中市,清水區,吳厝里,564,261,303,10,574,1465,39.18,17.82
臺中市,沙鹿區,居仁里,606,252,354,4,610,1364,44.72,18.48
臺中市,沙鹿區,洛泉里,1024,484,540,11,1035,1976,52.38,24.49
臺中市,沙鹿區,沙鹿里,466,175,291,3,469,893,52.52,19.6
臺中市,沙鹿區,美仁里,234,115,119,4,238,489,48.67,23.52
臺中市,沙鹿區,興仁里,1073,506,567,13,1086,2409,45.08,21.0
臺中市,沙鹿區,斗抵里,1980,924,1056,20,2000,4364,45.83,21.17
臺中市,沙鹿區,鹿峰里,2323,1018,1305,31,2354,5345,44.04,19.05
臺中市,沙鹿區,鹿寮里,3132,1219,1913,20,3152,6799,46.36,17.93
臺中市,沙鹿區,竹林里,3084,1535,1549,31,3115,7344,42.42,20.9
臺中市,沙鹿區,犁分里,472,208,264,5,477,1089,43.8,19.1
臺中市,沙鹿區,北勢里,1868,923,945,19,1887,4904,38.48,18.82
臺中市,沙鹿區,福興里,1609,827,782,14,1623,3843,42.23,21.52
臺中市,沙鹿區,晉江里,772,353,419,11,783,1748,44.79,20.19
臺中市,沙鹿區,六路里,2210,1026,1184,18,2228,5388,41.35,19.04
臺中市,沙鹿區,南勢里,1405,714,691,14,1419,3381,41.97,21.12
臺中市,沙鹿區,埔子里,2511,1305,1206,22,2533,5682,44.58,22.97
臺中市,沙鹿區,公明里,1794,1017,777,29,1823,4396,41.47,23.13
臺中市,沙鹿區,清泉里,1018,570,448,12,1030,2331,44.19,24.45
臺中市,沙鹿區,西勢里,852,474,378,12,864,2130,40.56,22.25
臺中市,沙鹿區,興安里,1451,637,814,13,1464,3365,43.51,18.93
臺中市,沙鹿區,三鹿里,3030,1575,1455,19,3049,7321,41.65,21.51
臺中市,梧棲區,頂寮里,1433,662,771,7,1440,3632,39.65,18.23
臺中市,梧棲區,下寮里,836,370,466,7,843,1967,42.86,18.81
臺中市,梧棲區,中正里,1491,737,754,16,1507,3879,38.85,19.0
臺中市,梧棲區,中和里,225,98,127,1,226,484,46.69,20.25
臺中市,梧棲區,文化里,489,236,253,5,494,1161,42.55,20.33
臺中市,梧棲區,安仁里,330,151,179,2,332,780,42.56,19.36
臺中市,梧棲區,草湳里,2413,1110,1303,23,2436,6132,39.73,18.1
臺中市,梧棲區,南簡里,1971,829,1142,25,1996,5294,37.7,15.66
臺中市,梧棲區,福德里,1750,767,983,18,1768,4953,35.7,15.49
臺中市,梧棲區,大庄里,2874,1308,1566,42,2916,7509,38.83,17.42
臺中市,梧棲區,大村里,2190,1008,1182,24,2214,5687,38.93,17.72
臺中市,梧棲區,興農里,828,364,464,9,837,2322,36.05,15.68
臺中市,梧棲區,永寧里,856,360,496,15,871,2298,37.9,15.67
臺中市,梧棲區,永安里,927,427,500,9,936,2493,37.55,17.13
臺中市,后里區,廣福里,775,505,270,20,795,2076,38.29,24.33
臺中市,后里區,仁里里,388,200,188,5,393,1031,38.12,19.4
臺中市,后里區,義里里,1188,690,498,16,1204,3086,39.01,22.36
臺中市,后里區,后里里,1562,781,781,15,1577,3652,43.18,21.39
臺中市,后里區,厚里里,828,407,421,12,840,2136,39.33,19.05
臺中市,后里區,墩東里,1915,968,947,23,1938,4739,40.89,20.43
臺中市,后里區,墩西里,765,329,436,2,767,1917,40.01,17.16
臺中市,后里區,墩南里,1331,605,726,11,1342,3347,40.1,18.08
臺中市,后里區,墩北里,1426,612,814,19,1445,3538,40.84,17.3
臺中市,后里區,中和里,933,408,525,18,951,2376,40.03,17.17
臺中市,后里區,舊社里,817,384,433,13,830,2187,37.95,17.56
臺中市,后里區,聯合里,616,275,341,6,622,1559,39.9,17.64
臺中市,后里區,太平里,706,331,375,6,712,2131,33.41,15.53
臺中市,后里區,眉山里,1144,583,561,12,1156,3198,36.15,18.23
臺中市,后里區,泰安里,521,225,296,5,526,1393,37.76,16.15
臺中市,后里區,公館里,733,313,420,17,750,2139,35.06,14.63
臺中市,后里區,月眉里,771,301,470,10,781,1956,39.93,15.39
臺中市,后里區,義德里,966,546,420,14,980,2591,37.82,21.07
臺中市,神岡區,神岡里,1237,595,642,11,1248,3173,39.33,18.75
臺中市,神岡區,庄前里,954,434,520,11,965,2296,42.03,18.9
臺中市,神岡區,北庄里,1055,446,609,9,1064,2611,40.75,17.08
臺中市,神岡區,庄後里,937,342,595,8,945,2220,42.57,15.41
臺中市,神岡區,社口里,2841,1199,1642,17,2858,7481,38.2,16.03
臺中市,神岡區,社南里,2093,787,1306,19,2112,5257,40.18,14.97
臺中市,神岡區,三角里,1081,402,679,7,1088,2555,42.58,15.73
臺中市,神岡區,岸裡里,1183,430,753,14,1197,2845,42.07,15.11
臺中市,神岡區,大社里,1687,761,926,11,1698,4465,38.03,17.04
臺中市,神岡區,豐洲里,2787,1170,1617,27,2814,7152,39.35,16.36
臺中市,神岡區,神洲里,1075,412,663,19,1094,2539,43.09,16.23
臺中市,神岡區,溪洲里,1108,446,662,17,1125,2800,40.18,15.93
臺中市,神岡區,圳前里,887,419,468,18,905,2268,39.9,18.47
臺中市,神岡區,新庄里,1458,591,867,13,1471,4135,35.57,14.29
臺中市,神岡區,圳堵里,800,383,417,8,808,2090,38.66,18.33
臺中市,神岡區,山皮里,412,139,273,4,416,1016,40.94,13.68
臺中市,潭子區,潭陽里,4314,2020,2294,38,4352,10990,39.6,18.38
臺中市,潭子區,潭秀里,595,224,371,7,602,1262,47.7,17.75
臺中市,潭子區,潭北里,1020,539,481,5,1025,2378,43.1,22.67
臺中市,潭子區,福仁里,4181,2165,2016,28,4209,10488,40.13,20.64
臺中市,潭子區,頭家里,2273,1159,1114,23,2296,5345,42.96,21.68
臺中市,潭子區,甘蔗里,3864,1944,1920,30,3894,9332,41.73,20.83
臺中市,潭子區,東寶里,5012,2299,2713,44,5056,12018,42.07,19.13
臺中市,潭子區,大富里,1215,540,675,10,1225,2801,43.73,19.28
臺中市,潭子區,大豐里,2547,1124,1423,28,2575,6066,42.45,18.53
臺中市,潭子區,栗林里,2111,878,1233,24,2135,4733,45.11,18.55
臺中市,潭子區,嘉仁里,1604,846,758,24,1628,3997,40.73,21.17
臺中市,潭子區,新田里,661,250,411,6,667,1536,43.42,16.28
臺中市,潭子區,聚興里,1574,734,840,22,1596,4262,37.45,17.22
臺中市,潭子區,頭家東里,1763,870,893,11,1774,4319,41.07,20.14
臺中市,潭子區,家興里,2892,1518,1374,22,2914,6933,42.03,21.9
臺中市,潭子區,家福里,1984,1008,976,27,2011,4575,43.96,22.03
臺中市,大雅區,大雅里,1783,883,900,20,1803,4325,41.69,20.42
臺中市,大雅區,員林里,3618,1653,1965,34,3652,9201,39.69,17.97
臺中市,大雅區,六寶里,2399,1285,1114,25,2424,6208,39.05,20.7
臺中市,大雅區,秀山里,1342,607,735,14,1356,3353,40.44,18.1
臺中市,大雅區,忠義里,1297,959,338,16,1313,3594,36.53,26.68
臺中市,大雅區,橫山里,1698,804,894,21,1719,4313,39.86,18.64
臺中市,大雅區,三和里,2032,978,1054,32,2064,5252,39.3,18.62
臺中市,大雅區,西寶里,1756,797,959,13,1769,4779,37.02,16.68
臺中市,大雅區,上楓里,2294,1058,1236,22,2316,6244,37.09,16.94
臺中市,大雅區,二和里,2310,1166,1144,20,2330,5915,39.39,19.71
臺中市,大雅區,四德里,1927,996,931,11,1938,4622,41.93,21.55
臺中市,大雅區,上雅里,2269,1074,1195,25,2294,6037,38.0,17.79
臺中市,大雅區,文雅里,2346,1231,1115,20,2366,6021,39.3,20.45
臺中市,大雅區,大楓里,1952,945,1007,20,1972,5029,39.21,18.79
臺中市,大雅區,雅楓里,1326,668,658,13,1339,3545,37.77,18.84
臺中市,新社區,新社里,1366,739,627,21,1387,3261,42.53,22.66
臺中市,新社區,復盛里,605,341,264,8,613,1835,33.41,18.58
臺中市,新社區,中正里,536,278,258,7,543,1342,40.46,20.72
臺中市,新社區,月湖里,379,153,226,10,389,986,39.45,15.52
臺中市,新社區,崑山里,467,156,311,5,472,1156,40.83,13.49
臺中市,新社區,大南里,723,374,349,14,737,1879,39.22,19.9
臺中市,新社區,永源里,1157,455,702,20,1177,2983,39.46,15.25
臺中市,新社區,中興里,265,200,65,2,267,582,45.88,34.36
臺中市,新社區,協成里,1096,484,612,19,1115,2927,38.09,16.54
臺中市,新社區,東興里,490,296,194,8,498,1187,41.95,24.94
臺中市,新社區,慶西里,315,130,185,11,326,885,36.84,14.69
臺中市,新社區,中和里,225,170,55,7,232,575,40.35,29.57
臺中市,新社區,福興里,417,230,187,5,422,1112,37.95,20.68
臺中市,石岡區,石岡里,440,223,217,6,446,1210,36.86,18.43
臺中市,石岡區,萬安里,650,328,322,6,656,1518,43.21,21.61
臺中市,石岡區,九房里,521,266,255,5,526,1204,43.69,22.09
臺中市,石岡區,金星里,459,221,238,10,469,1232,38.07,17.94
臺中市,石岡區,龍興里,260,120,140,3,263,638,41.22,18.81
臺中市,石岡區,萬興里,621,323,298,6,627,1443,43.45,22.38
臺中市,石岡區,梅子里,750,395,355,14,764,1794,42.59,22.02
臺中市,石岡區,土牛里,412,238,174,9,421,1002,42.02,23.75
臺中市,石岡區,德興里,573,334,239,8,581,1408,41.26,23.72
臺中市,石岡區,和盛里,529,309,220,4,533,1230,43.33,25.12
臺中市,外埔區,永豐里,386,199,187,4,390,1099,35.49,18.11
臺中市,外埔區,六分里,778,424,354,2,780,2193,35.57,19.33
臺中市,外埔區,三崁里,619,316,303,8,627,1887,33.23,16.75
臺中市,外埔區,大同里,1762,975,787,19,1781,4680,38.06,20.83
臺中市,外埔區,水美里,1253,634,619,16,1269,3392,37.41,18.69
臺中市,外埔區,大東里,2333,1216,1117,29,2362,6342,37.24,19.17
臺中市,外埔區,馬鳴里,476,224,252,5,481,1384,34.75,16.18
臺中市,外埔區,中山里,520,288,232,6,526,1210,43.47,23.8
臺中市,外埔區,鐵山里,701,384,317,10,711,2115,33.62,18.16
臺中市,外埔區,土城里,594,243,351,5,599,1581,37.89,15.37
臺中市,外埔區,廍子里,349,161,188,6,355,1158,30.66,13.9
臺中市,大安區,南埔里,354,129,225,8,362,1055,34.31,12.23
臺中市,大安區,南庄里,356,161,195,1,357,1023,34.9,15.74
臺中市,大安區,中庄里,857,372,485,11,868,2624,33.08,14.18
臺中市,大安區,龜壳里,521,249,272,7,528,1502,35.15,16.58
臺中市,大安區,福興里,392,152,240,8,400,1149,34.81,13.23
臺中市,大安區,東安里,445,185,260,5,450,1199,37.53,15.43
臺中市,大安區,頂安里,337,157,180,9,346,889,38.92,17.66
臺中市,大安區,永安里,556,262,294,14,570,1753,32.52,14.95
臺中市,大安區,福住里,336,150,186,2,338,1037,32.59,14.46
臺中市,大安區,海墘里,450,239,211,4,454,1385,32.78,17.26
臺中市,大安區,西安里,607,298,309,14,621,1738,35.73,17.15
臺中市,大安區,松雅里,439,176,263,4,443,966,45.86,18.22
臺中市,烏日區,烏日里,4119,1900,2219,42,4161,8638,48.17,22.0
臺中市,烏日區,湖日里,1150,515,635,14,1164,2486,46.82,20.72
臺中市,烏日區,三和里,2494,1218,1276,27,2521,5768,43.71,21.12
臺中市,烏日區,榮泉里,2457,1259,1198,20,2477,5795,42.74,21.73
臺中市,烏日區,學田里,1140,602,538,11,1151,2612,44.07,23.05
臺中市,烏日區,九德里,5794,2655,3139,36,5830,12829,45.44,20.7
臺中市,烏日區,仁德里,3560,1698,1862,34,3594,7556,47.56,22.47
臺中市,烏日區,前竹里,800,314,486,7,807,1621,49.78,19.37
臺中市,烏日區,五光里,752,329,423,9,761,1676,45.41,19.63
臺中市,烏日區,光明里,938,405,533,10,948,2095,45.25,19.33
臺中市,烏日區,東園里,972,421,551,12,984,2196,44.81,19.17
臺中市,烏日區,溪埧里,1923,861,1062,21,1944,4327,44.93,19.9
臺中市,烏日區,螺潭里,1070,487,583,13,1083,2158,50.19,22.57
臺中市,烏日區,北里里,753,314,439,8,761,1651,46.09,19.02
臺中市,烏日區,南里里,654,351,303,5,659,1350,48.81,26.0
臺中市,烏日區,溪尾里,361,207,154,9,370,829,44.63,24.97
臺中市,大肚區,王田里,1736,756,980,21,1757,4325,40.62,17.48
臺中市,大肚區,中和里,412,188,224,3,415,865,47.98,21.73
臺中市,大肚區,福山里,1495,682,813,7,1502,3486,43.09,19.56
臺中市,大肚區,營埔里,637,308,329,11,648,1505,43.06,20.47
臺中市,大肚區,社腳里,1099,570,529,7,1106,2438,45.37,23.38
臺中市,大肚區,新興里,1124,566,558,10,1134,2601,43.6,21.76
臺中市,大肚區,大東里,1370,727,643,10,1380,3003,45.95,24.21
臺中市,大肚區,大肚里,1091,565,526,12,1103,2165,50.95,26.1
臺中市,大肚區,永和里,397,204,193,6,403,819,49.21,24.91
臺中市,大肚區,磺溪里,730,352,378,4,734,1699,43.2,20.72
臺中市,大肚區,永順里,768,331,437,8,776,1688,45.97,19.61
臺中市,大肚區,成功里,369,211,158,5,374,943,39.66,22.38
臺中市,大肚區,山陽里,573,277,296,11,584,1310,44.58,21.15
臺中市,大肚區,頂街里,3204,1659,1545,26,3230,7418,43.54,22.36
臺中市,大肚區,瑞井里,2050,947,1103,23,2073,5061,40.96,18.71
臺中市,大肚區,蔗廍里,1939,787,1152,14,1953,4958,39.39,15.87
臺中市,大肚區,自強里,1497,792,705,19,1516,3471,43.68,22.82
臺中市,龍井區,竹坑里,1237,634,603,7,1244,3019,41.21,21.0
臺中市,龍井區,龍東里,1156,549,607,9,1165,2849,40.89,19.27
臺中市,龍井區,龍西里,772,417,355,12,784,1822,43.03,22.89
臺中市,龍井區,田中里,1579,735,844,15,1594,3624,43.98,20.28
臺中市,龍井區,福田里,379,201,178,4,383,1043,36.72,19.27
臺中市,龍井區,麗水里,927,510,417,7,934,2271,41.13,22.46
臺中市,龍井區,龍津里,1988,865,1123,20,2008,5015,40.04,17.25
臺中市,龍井區,三德里,1034,425,609,15,1049,2952,35.54,14.4
臺中市,龍井區,忠和里,1969,801,1168,18,1987,4892,40.62,16.37
臺中市,龍井區,山腳里,2180,970,1210,31,2211,5745,38.49,16.88
臺中市,龍井區,龍泉里,3091,1500,1591,29,3120,7612,40.99,19.71
臺中市,龍井區,龍崗里,1082,508,574,4,1086,2640,41.14,19.24
臺中市,龍井區,新庄里,2524,1223,1301,26,2550,6354,40.13,19.25
臺中市,龍井區,南寮里,702,297,405,9,711,1558,45.64,19.06
臺中市,龍井區,新東里,2079,1071,1008,18,2097,4747,44.18,22.56
臺中市,龍井區,東海里,3820,2134,1686,38,3858,8616,44.78,24.77
臺中市,霧峰區,桐林里,538,260,278,8,546,1194,45.73,21.78
臺中市,霧峰區,吉峰里,3990,1972,2018,34,4024,9381,42.9,21.02
臺中市,霧峰區,甲寅里,1970,1010,960,16,1986,4671,42.52,21.62
臺中市,霧峰區,本鄉里,1095,508,587,4,1099,2320,47.37,21.9
臺中市,霧峰區,中正里,997,511,486,6,1003,2025,49.53,25.23
臺中市,霧峰區,錦榮里,564,280,284,4,568,1224,46.41,22.88
臺中市,霧峰區,萊園里,489,207,282,7,496,1045,47.46,19.81
臺中市,霧峰區,本堂里,2659,1413,1246,19,2678,5783,46.31,24.43
臺中市,霧峰區,坑口里,1330,696,634,15,1345,2918,46.09,23.85
臺中市,霧峰區,北柳里,1758,790,968,10,1768,3965,44.59,19.92
臺中市,霧峰區,南柳里,911,431,480,11,922,1860,49.57,23.17
臺中市,霧峰區,四德里,1030,447,583,9,1039,2470,42.06,18.1
臺中市,霧峰區,五福里,1192,562,630,19,1211,2651,45.68,21.2
臺中市,霧峰區,萬豐里,1103,474,629,9,1112,2577,43.15,18.39
臺中市,霧峰區,舊正里,881,402,479,9,890,2046,43.5,19.65
臺中市,霧峰區,峰谷里,434,167,267,2,436,1104,39.49,15.13
臺中市,霧峰區,六股里,1111,437,674,16,1127,2352,47.92,18.58
臺中市,霧峰區,丁台里,1069,409,660,18,1087,2284,47.59,17.91
臺中市,霧峰區,北勢里,951,531,420,3,954,2071,46.06,25.64
臺中市,霧峰區,南勢里,557,261,296,3,560,1307,42.85,19.97
臺中市,太平區,太平里,2169,921,1248,31,2200,5378,40.91,17.13
臺中市,太平區,長億里,2410,1179,1231,25,2435,6193,39.32,19.04
臺中市,太平區,中平里,1588,690,898,14,1602,4030,39.75,17.12
臺中市,太平區,中興里,1327,572,755,13,1340,3192,41.98,17.92
臺中市,太平區,建國里,1119,516,603,19,1138,2873,39.61,17.96
臺中市,太平區,東平里,1527,683,844,15,1542,4108,37.54,16.63
臺中市,太平區,宜欣里,2313,1044,1269,24,2337,6203,37.68,16.83
臺中市,太平區,中山里,1272,735,537,11,1283,3727,34.42,19.72
臺中市,太平區,坪林里,1445,834,611,12,1457,3294,44.23,25.32
臺中市,太平區,光華里,2075,1134,941,28,2103,5188,40.54,21.86
臺中市,太平區,新坪里,2765,1441,1324,19,2784,7707,36.12,18.7
臺中市,太平區,新光里,3075,1469,1606,39,3114,7600,40.97,19.33
臺中市,太平區,新福里,2735,1390,1345,25,2760,6669,41.39,20.84
臺中市,太平區,頭汴里,656,319,337,9,665,1767,37.63,18.05
臺中市,太平區,東汴里,400,163,237,7,407,1199,33.94,13.59
臺中市,太平區,興隆里,1179,579,600,18,1197,3227,37.09,17.94
臺中市,太平區,光隆里,1187,428,759,8,1195,3052,39.15,14.02
臺中市,太平區,德隆里,1772,731,1041,20,1792,4742,37.79,15.42
臺中市,太平區,黃竹里,245,102,143,8,253,649,38.98,15.72
臺中市,太平區,永成里,2527,1160,1367,27,2554,6807,37.52,17.04
臺中市,太平區,永平里,1533,691,842,10,1543,4018,38.4,17.2
臺中市,太平區,成功里,1450,612,838,17,1467,3985,36.81,15.36
臺中市,太平區,東和里,1022,485,537,10,1032,2818,36.62,17.21
臺中市,太平區,中政里,1391,644,747,13,1404,3701,37.94,17.4
臺中市,太平區,平安里,870,376,494,10,880,2204,39.93,17.06
臺中市,太平區,建興里,1004,461,543,4,1008,2894,34.83,15.93
臺中市,太平區,新興里,2243,1070,1173,22,2265,5508,41.12,19.43
臺中市,太平區,新高里,3236,1616,1620,27,3263,8031,40.63,20.12
臺中市,太平區,新吉里,2198,1166,1032,21,2219,5692,38.98,20.48
臺中市,太平區,新城里,1942,1025,917,22,1964,5664,34.68,18.1
臺中市,太平區,宜佳里,2302,1197,1105,21,2323,6055,38.36,19.77
臺中市,太平區,宜昌里,1398,603,795,16,1414,3821,37.01,15.78
臺中市,太平區,光明里,1504,868,636,9,1513,3832,39.48,22.65
臺中市,太平區,豐年里,1905,1038,867,20,1925,4323,44.53,24.01
臺中市,太平區,大興里,930,449,481,9,939,2539,36.98,17.68
臺中市,太平區,勤益里,896,529,367,14,910,2139,42.54,24.73
臺中市,太平區,聖和里,586,261,325,8,594,1536,38.67,16.99
臺中市,太平區,福隆里,1451,651,800,14,1465,3631,40.35,17.93
臺中市,太平區,永隆里,891,431,460,16,907,2486,36.48,17.34
臺中市,大里區,大里里,1533,702,831,20,1553,3731,41.62,18.82
臺中市,大里區,新里里,4240,1967,2273,28,4268,10438,40.89,18.84
臺中市,大里區,樹王里,1556,608,948,16,1572,3621,43.41,16.79
臺中市,大里區,東興里,2900,1345,1555,29,2929,6901,42.44,19.49
臺中市,大里區,祥興里,3087,1368,1719,34,3121,7279,42.88,18.79
臺中市,大里區,日新里,1815,883,932,20,1835,4162,44.09,21.22
臺中市,大里區,西榮里,2201,1015,1186,20,2221,5520,40.24,18.39
臺中市,大里區,內新里,3382,1718,1664,24,3406,8350,40.79,20.57
臺中市,大里區,東昇里,1411,664,747,20,1431,3400,42.09,19.53
臺中市,大里區,立仁里,1968,861,1107,26,1994,5356,37.23,16.08
臺中市,大里區,新仁里,3231,1450,1781,35,3266,7841,41.65,18.49
臺中市,大里區,大元里,1871,797,1074,23,1894,4167,45.45,19.13
臺中市,大里區,夏田里,464,162,302,5,469,982,47.76,16.5
臺中市,大里區,仁化里,3119,1363,1756,34,3153,8402,37.53,16.22
臺中市,大里區,健民里,1694,748,946,21,1715,4704,36.46,15.9
臺中市,大里區,塗城里,3187,1374,1813,40,3227,8359,38.61,16.44
臺中市,大里區,瑞城里,4482,2087,2395,36,4518,11593,38.97,18.0
臺中市,大里區,金城里,3741,1754,1987,33,3774,9507,39.7,18.45
臺中市,大里區,東湖里,4015,1879,2136,41,4056,10403,38.99,18.06
臺中市,大里區,西湖里,1164,500,664,15,1179,2803,42.06,17.84
臺中市,大里區,國光里,2450,1234,1216,17,2467,5719,43.14,21.58
臺中市,大里區,大明里,1676,763,913,11,1687,4144,40.71,18.41
臺中市,大里區,永隆里,4420,2248,2172,29,4449,9667,46.02,23.25
臺中市,大里區,長榮里,3796,1882,1914,45,3841,8636,44.48,21.79
臺中市,大里區,中新里,2122,1076,1046,21,2143,5389,39.77,19.97
臺中市,大里區,立德里,3019,1398,1621,26,3045,7712,39.48,18.13
臺中市,大里區,仁德里,2321,1032,1289,12,2333,5865,39.78,17.6
臺中市,和平區,南勢里,646,411,235,14,660,1883,35.05,21.83
臺中市,和平區,天輪里,141,71,70,4,145,456,31.8,15.57
臺中市,和平區,博愛里,528,390,138,7,535,1641,32.6,23.77
臺中市,和平區,中坑里,192,131,61,3,195,461,42.3,28.42
臺中市,和平區,自由里,423,323,100,2,425,1081,39.32,29.88
臺中市,和平區,達觀里,420,297,123,2,422,1107,38.12,26.83
臺中市,和平區,梨山里,429,272,157,4,433,1939,22.33,14.03
臺中市,和平區,平等里,210,159,51,2,212,868,24.42,18.32
臺南市,新營區,忠政里,1942,1018,924,12,1954,4561,42.84,22.32
臺南市,新營區,民權里,912,403,509,5,917,2212,41.46,18.22
臺南市,新營區,三仙里,1152,481,671,4,1156,2807,41.18,17.14
臺南市,新營區,大宏里,1168,487,681,11,1179,2795,42.18,17.42
臺南市,新營區,王公里,1578,699,879,11,1589,4010,39.63,17.43
臺南市,新營區,中營里,475,197,278,2,477,1131,42.18,17.42
臺南市,新營區,土庫里,568,178,390,9,577,1430,40.35,12.45
臺南市,新營區,南興里,885,395,490,6,891,2371,37.58,16.66
臺南市,新營區,興業里,730,363,367,12,742,1734,42.79,20.93
臺南市,新營區,民生里,1199,471,728,13,1212,3194,37.95,14.75
臺南市,新營區,民榮里,1644,638,1006,17,1661,4405,37.71,14.48
臺南市,新營區,埤寮里,640,231,409,14,654,1632,40.07,14.15
臺南市,新營區,護鎮里,514,164,350,2,516,1333,38.71,12.3
臺南市,新營區,太南里,598,159,439,7,605,1724,35.09,9.22
臺南市,新營區,太北里,657,195,462,5,662,1696,39.03,11.5
臺南市,新營區,南紙里,1322,579,743,13,1335,3665,36.43,15.8
臺南市,新營區,嘉芳里,657,233,424,8,665,1880,35.37,12.39
臺南市,新營區,五興里,607,156,451,8,615,1555,39.55,10.03
臺南市,新營區,姑爺里,342,105,237,5,347,897,38.68,11.71
臺南市,新營區,新北里,1882,859,1023,14,1896,4874,38.9,17.62
臺南市,新營區,新南里,2047,852,1195,9,2056,5086,40.42,16.75
臺南市,新營區,新東里,2498,1225,1273,23,2521,6401,39.38,19.14
臺南市,新營區,永平里,1130,468,662,11,1141,2599,43.9,18.01
臺南市,鹽水區,水秀里,589,192,397,5,594,1549,38.35,12.4
臺南市,鹽水區,橋南里,1296,459,837,13,1309,3724,35.15,12.33
臺南市,鹽水區,汫水里,306,39,267,18,324,875,37.03,4.46
臺南市,鹽水區,岸內里,1443,519,924,20,1463,3815,38.35,13.6
臺南市,鹽水區,歡雅里,606,181,425,8,614,1621,37.88,11.17
臺南市,鹽水區,津城里,607,221,386,8,615,1413,43.52,15.64
臺南市,鹽水區,月港里,651,278,373,2,653,1575,41.46,17.65
臺南市,鹽水區,三明里,621,143,478,6,627,1519,41.28,9.41
臺南市,鹽水區,義中里,562,157,405,8,570,1545,36.89,10.16
臺南市,鹽水區,文昌里,366,109,257,3,369,981,37.61,11.11
臺南市,鹽水區,竹林里,436,107,329,8,444,1073,41.38,9.97
臺南市,鹽水區,三和里,369,119,250,7,376,900,41.78,13.22
臺南市,鹽水區,坔頭港里,463,131,332,12,475,1360,34.93,9.63
臺南市,白河區,白河里,670,216,454,4,674,1688,39.93,12.8
臺南市,白河區,永安里,1266,415,851,12,1278,2937,43.51,14.13
臺南市,白河區,外角里,546,176,370,4,550,1364,40.32,12.9
臺南市,白河區,庄內里,645,201,444,7,652,1596,40.85,12.59
臺南市,白河區,秀祐里,337,105,232,5,342,874,39.13,12.01
臺南市,白河區,河東里,541,175,366,13,554,1334,41.53,13.12
臺南市,白河區,虎山里,175,64,111,3,178,440,40.45,14.55
臺南市,白河區,大林里,182,42,140,1,183,560,32.68,7.5
臺南市,白河區,崁頭里,122,39,83,1,123,369,33.33,10.57
臺南市,白河區,六溪里,160,36,124,2,162,487,33.26,7.39
臺南市,白河區,仙草里,382,143,239,6,388,1178,32.94,12.14
臺南市,白河區,關嶺里,333,95,238,4,337,1001,33.67,9.49
臺南市,白河區,大竹里,492,158,334,6,498,1380,36.09,11.45
臺南市,白河區,竹門里,317,108,209,8,325,836,38.88,12.92
臺南市,白河區,崎內里,190,85,105,4,194,705,27.52,12.06
臺南市,白河區,昇安里,477,141,336,6,483,1303,37.07,10.82
臺南市,白河區,汴頭里,276,69,207,9,285,707,40.31,9.76
臺南市,白河區,內角里,251,76,175,6,257,657,39.12,11.57
臺南市,白河區,詔豐里,741,214,527,14,755,1930,39.12,11.09
臺南市,白河區,廣蓮里,586,164,422,4,590,1458,40.47,11.25
臺南市,白河區,馬稠後里,441,125,316,11,452,1318,34.29,9.48
臺南市,柳營區,士林里,712,236,476,9,721,1825,39.51,12.93
臺南市,柳營區,光福里,705,258,447,3,708,1608,44.03,16.04
臺南市,柳營區,中埕里,444,166,278,9,453,1107,40.92,15.0
臺南市,柳營區,東昇里,1095,385,710,7,1102,2722,40.48,14.14
臺南市,柳營區,八翁里,504,158,346,7,511,1368,37.35,11.55
臺南市,柳營區,人和里,296,106,190,2,298,727,40.99,14.58
臺南市,柳營區,太康里,602,202,400,14,616,1454,42.37,13.89
臺南市,柳營區,重溪里,646,183,463,6,652,1738,37.51,10.53
臺南市,柳營區,篤農里,469,137,332,6,475,1275,37.25,10.75
臺南市,柳營區,大農里,256,61,195,2,258,652,39.57,9.36
臺南市,柳營區,神農里,484,139,345,6,490,1337,36.65,10.4
臺南市,柳營區,果毅里,438,132,306,3,441,1192,37.0,11.07
臺南市,柳營區,旭山里,506,163,343,1,507,1517,33.42,10.74
臺南市,後壁區,後壁里,690,259,431,7,697,1620,43.02,15.99
臺南市,後壁區,侯伯里,507,160,347,4,511,1264,40.43,12.66
臺南市,後壁區,嘉苳里,481,152,329,4,485,1275,38.04,11.92
臺南市,後壁區,土溝里,526,131,395,6,532,1304,40.8,10.05
臺南市,後壁區,竹新里,573,120,453,8,581,1336,43.49,8.98
臺南市,後壁區,新東里,603,191,412,10,613,1610,38.07,11.86
臺南市,後壁區,頂安里,479,181,298,12,491,1223,40.15,14.8
臺南市,後壁區,長安里,506,190,316,7,513,1216,42.19,15.63
臺南市,後壁區,福安里,682,225,457,8,690,1753,39.36,12.84
臺南市,後壁區,菁寮里,560,187,373,11,571,1379,41.41,13.56
臺南市,後壁區,新嘉里,302,82,220,5,307,966,31.78,8.49
臺南市,後壁區,長短樹里,817,254,563,17,834,1961,42.53,12.95
臺南市,後壁區,上茄苳里,861,241,620,12,873,2164,40.34,11.14
臺南市,後壁區,菁豐里,446,144,302,10,456,1194,38.19,12.06
臺南市,東山區,東山里,477,205,272,5,482,1400,34.43,14.64
臺南市,東山區,東中里,868,327,541,7,875,2475,35.35,13.21
臺南市,東山區,東正里,470,139,331,2,472,1405,33.59,9.89
臺南市,東山區,三榮里,286,82,204,2,288,920,31.3,8.91
臺南市,東山區,大客里,295,98,197,3,298,1058,28.17,9.26
臺南市,東山區,科里里,414,125,289,10,424,1193,35.54,10.48
臺南市,東山區,東河里,292,74,218,8,300,826,36.32,8.96
臺南市,東山區,南溪里,117,31,86,1,118,420,28.1,7.38
臺南市,東山區,水雲里,106,31,75,0,106,376,28.19,8.24
臺南市,東山區,林安里,135,43,92,5,140,370,37.84,11.62
臺南市,東山區,東原里,618,231,387,10,628,2040,30.78,11.32
臺南市,東山區,嶺南里,146,51,95,2,148,647,22.87,7.88
臺南市,東山區,南勢里,278,81,197,2,280,1054,26.57,7.69
臺南市,東山區,青山里,301,111,190,3,304,1052,28.9,10.55
臺南市,東山區,高原里,219,110,109,2,221,877,25.2,12.54
臺南市,東山區,聖賢里,716,213,503,17,733,1847,39.69,11.53
臺南市,麻豆區,東角里,1120,377,743,12,1132,2562,44.18,14.72
臺南市,麻豆區,晋江里,1102,304,798,18,1120,2463,45.47,12.34
臺南市,麻豆區,巷口里,965,312,653,10,975,2086,46.74,14.96
臺南市,麻豆區,中興里,847,268,579,11,858,1936,44.32,13.84
臺南市,麻豆區,興農里,650,179,471,3,653,1433,45.57,12.49
臺南市,麻豆區,油車里,1588,407,1181,15,1603,3474,46.14,11.72
臺南市,麻豆區,北勢里,457,73,384,4,461,1093,42.18,6.68
臺南市,麻豆區,大埕里,1246,358,888,13,1259,2846,44.24,12.58
臺南市,麻豆區,南勢里,992,348,644,8,1000,2315,43.2,15.03
臺南市,麻豆區,寮廍里,744,148,596,7,751,1645,45.65,9.0
臺南市,麻豆區,埤頭里,950,169,781,13,963,2284,42.16,7.4
臺南市,麻豆區,海埔里,827,200,627,20,847,2089,40.55,9.57
臺南市,麻豆區,港尾里,517,131,386,7,524,1232,42.53,10.63
臺南市,麻豆區,麻口里,443,96,347,6,449,1171,38.34,8.2
臺南市,麻豆區,安業里,625,127,498,8,633,1297,48.8,9.79
臺南市,麻豆區,安正里,376,95,281,3,379,925,40.97,10.27
臺南市,麻豆區,新興里,797,194,603,8,805,1871,43.03,10.37
臺南市,麻豆區,謝厝寮里,768,145,623,20,788,1633,48.25,8.88
臺南市,麻豆區,井東里,751,168,583,9,760,1704,44.6,9.86
臺南市,麻豆區,清水里,620,170,450,5,625,1449,43.13,11.73
臺南市,下營區,下營里,616,229,387,5,621,1503,41.32,15.24
臺南市,下營區,仁里里,698,231,467,9,707,1925,36.73,12.0
臺南市,下營區,宅內里,606,231,375,8,614,1601,38.35,14.43
臺南市,下營區,後街里,610,223,387,5,615,1555,39.55,14.34
臺南市,下營區,新興里,682,236,446,4,686,1945,35.27,12.13
臺南市,下營區,營前里,805,293,512,13,818,2079,39.35,14.09
臺南市,下營區,開化里,727,212,515,8,735,1817,40.45,11.67
臺南市,下營區,西連里,387,89,298,10,397,866,45.84,10.28
臺南市,下營區,賀建里,425,131,294,2,427,1269,33.65,10.32
臺南市,下營區,茅營里,852,222,630,7,859,2146,40.03,10.34
臺南市,下營區,大吉里,564,197,367,10,574,1539,37.3,12.8
臺南市,下營區,紅甲里,859,207,652,8,867,2173,39.9,9.53
臺南市,六甲區,六甲里,1057,345,712,13,1070,2866,37.33,12.04
臺南市,六甲區,甲東里,954,281,673,17,971,2601,37.33,10.8
臺南市,六甲區,甲南里,545,181,364,7,552,1327,41.6,13.64
臺南市,六甲區,七甲里,694,202,492,10,704,1910,36.86,10.58
臺南市,六甲區,二甲里,1257,391,866,17,1274,3299,38.62,11.85
臺南市,六甲區,水林里,765,223,542,11,776,2062,37.63,10.81
臺南市,六甲區,中社里,612,206,406,12,624,1583,39.42,13.01
臺南市,六甲區,龜港里,475,164,311,5,480,1229,39.06,13.34
臺南市,六甲區,菁埔里,265,103,162,3,268,583,45.97,17.67
臺南市,六甲區,王爺里,195,55,140,1,196,719,27.26,7.65
臺南市,六甲區,大丘里,184,51,133,1,185,580,31.9,8.79
臺南市,官田區,官田里,812,269,543,5,817,2045,39.95,13.15
臺南市,官田區,二鎮里,1313,302,1011,17,1330,3141,42.34,9.61
臺南市,官田區,大崎里,143,50,93,3,146,402,36.32,12.44
臺南市,官田區,隆田里,785,296,489,8,793,1948,40.71,15.2
臺南市,官田區,隆本里,1409,536,873,16,1425,3476,41.0,15.42
臺南市,官田區,南廍里,455,119,336,6,461,1243,37.09,9.57
臺南市,官田區,社子里,314,69,245,2,316,855,36.96,8.07
臺南市,官田區,烏山頭里,521,134,387,4,525,1197,43.86,11.19
臺南市,官田區,渡拔里,1080,333,747,20,1100,2498,44.04,13.33
臺南市,官田區,東西庄里,803,99,704,11,814,1798,45.27,5.51
臺南市,大內區,石湖里,384,126,258,5,389,992,39.21,12.7
臺南市,大內區,石林里,229,52,177,6,235,619,37.96,8.4
臺南市,大內區,石城里,522,133,389,7,529,1411,37.49,9.43
臺南市,大內區,內江里,327,127,200,3,330,885,37.29,14.35
臺南市,大內區,大內里,350,122,228,6,356,744,47.85,16.4
臺南市,大內區,內郭里,250,70,180,2,252,598,42.14,11.71
臺南市,大內區,頭社里,337,104,233,3,340,969,35.09,10.73
臺南市,大內區,環湖里,235,72,163,6,241,722,33.38,9.97
臺南市,大內區,二溪里,328,117,211,3,331,822,40.27,14.23
臺南市,大內區,曲溪里,223,51,172,3,226,550,41.09,9.27
臺南市,佳里區,東寧里,992,327,665,15,1007,2192,45.94,14.92
臺南市,佳里區,忠仁里,1081,331,750,8,1089,2827,38.52,11.71
臺南市,佳里區,鎮山里,2160,684,1476,10,2170,5534,39.21,12.36
臺南市,佳里區,建南里,1607,553,1054,8,1615,4239,38.1,13.05
臺南市,佳里區,安西里,2280,787,1493,16,2296,5723,40.12,13.75
臺南市,佳里區,六安里,1569,591,978,21,1590,3989,39.86,14.82
臺南市,佳里區,佳化里,810,242,568,9,819,2115,38.72,11.44
臺南市,佳里區,海澄里,769,239,530,12,781,2153,36.27,11.1
臺南市,佳里區,民安里,663,234,429,4,667,1660,40.18,14.1
臺南市,佳里區,子龍里,987,259,728,11,998,2328,42.87,11.13
臺南市,佳里區,營溪里,400,133,267,8,408,1045,39.04,12.73
臺南市,佳里區,文新里,2024,787,1237,5,2029,5063,40.08,15.54
臺南市,佳里區,佳興里,900,253,647,8,908,2103,43.18,12.03
臺南市,佳里區,下營里,724,227,497,1,725,1786,40.59,12.71
臺南市,佳里區,塭內里,1055,270,785,15,1070,2729,39.21,9.89
臺南市,佳里區,南勢里,1691,553,1138,10,1701,4415,38.53,12.53
臺南市,學甲區,仁得里,1586,489,1097,11,1597,3771,42.35,12.97
臺南市,學甲區,新榮里,884,262,622,6,890,2308,38.56,11.35
臺南市,學甲區,光華里,458,105,353,0,458,1207,37.95,8.7
臺南市,學甲區,宅港里,280,85,195,7,287,771,37.22,11.02
臺南市,學甲區,慈福里,778,274,504,4,782,1967,39.76,13.93
臺南市,學甲區,秀昌里,954,278,676,12,966,2463,39.22,11.29
臺南市,學甲區,明宜里,780,191,589,4,784,1887,41.55,10.12
臺南市,學甲區,豐和里,446,101,345,5,451,1175,38.38,8.6
臺南市,學甲區,平和里,373,59,314,4,377,1001,37.66,5.89
臺南市,學甲區,新達里,784,267,517,13,797,2054,38.8,13.0
臺南市,學甲區,大灣里,380,109,271,5,385,939,41.0,11.61
臺南市,學甲區,三慶里,475,142,333,8,483,1310,36.87,10.84
臺南市,學甲區,中洲里,467,139,328,6,473,1367,34.6,10.17
臺南市,西港區,西港里,1234,368,866,21,1255,3112,40.33,11.83
臺南市,西港區,南海里,978,240,738,13,991,2413,41.07,9.95
臺南市,西港區,港東里,601,159,442,2,603,1625,37.11,9.78
臺南市,西港區,檨林里,541,142,399,9,550,1640,33.54,8.66
臺南市,西港區,後營里,499,114,385,8,507,1436,35.31,7.94
臺南市,西港區,營西里,474,127,347,2,476,1456,32.69,8.72
臺南市,西港區,金砂里,315,84,231,4,319,758,42.08,11.08
臺南市,西港區,劉厝里,492,141,351,9,501,1338,37.44,10.54
臺南市,西港區,竹林里,556,135,421,5,561,1342,41.8,10.06
臺南市,西港區,永樂里,539,135,404,4,543,1352,40.16,9.99
臺南市,西港區,新復里,281,110,171,5,286,805,35.53,13.66
臺南市,西港區,慶安里,1574,486,1088,11,1585,4193,37.8,11.59
臺南市,七股區,後港里,393,96,297,0,393,998,39.38,9.62
臺南市,七股區,大潭里,233,50,183,3,236,648,36.42,7.72
臺南市,七股區,篤加里,306,97,209,2,308,820,37.56,11.83
臺南市,七股區,頂山里,308,94,214,3,311,809,38.44,11.62
臺南市,七股區,西寮里,164,43,121,1,165,444,37.16,9.68
臺南市,七股區,塩埕里,154,32,122,1,155,410,37.8,7.8
臺南市,七股區,龍山里,607,123,484,9,616,1608,38.31,7.65
臺南市,七股區,溪南里,129,47,82,0,129,343,37.61,13.7
臺南市,七股區,七股里,344,72,272,3,347,861,40.3,8.36
臺南市,七股區,玉成里,276,80,196,5,281,775,36.26,10.32
臺南市,七股區,大埕里,884,204,680,8,892,2548,35.01,8.01
臺南市,七股區,樹林里,626,130,496,9,635,1894,33.53,6.86
臺南市,七股區,中寮里,236,58,178,3,239,683,34.99,8.49
臺南市,七股區,竹橋里,481,137,344,9,490,1214,40.36,11.29
臺南市,七股區,義合里,706,198,508,11,717,1858,38.59,10.66
臺南市,七股區,永吉里,344,121,223,4,348,992,35.08,12.2
臺南市,七股區,三股里,442,122,320,4,446,1329,33.56,9.18
臺南市,七股區,十份里,429,147,282,6,435,1361,31.96,10.8
臺南市,將軍區,長榮里,430,130,300,9,439,1136,38.64,11.44
臺南市,將軍區,玉山里,260,54,206,3,263,821,32.03,6.58
臺南市,將軍區,廣山里,182,62,120,5,187,636,29.4,9.75
臺南市,將軍區,長沙里,447,99,348,7,454,1312,34.6,7.55
臺南市,將軍區,平沙里,426,93,333,9,435,1171,37.15,7.94
臺南市,將軍區,鯤鯓里,658,128,530,4,662,1862,35.55,6.87
臺南市,將軍區,鯤溟里,273,60,213,5,278,946,29.39,6.34
臺南市,將軍區,巷埔里,470,96,374,3,473,1166,40.57,8.23
臺南市,將軍區,西甲里,913,256,657,7,920,2358,39.02,10.86
臺南市,將軍區,忠嘉里,844,246,598,17,861,2413,35.68,10.19
臺南市,將軍區,苓仔寮里,758,200,558,10,768,1964,39.1,10.18
臺南市,將軍區,將軍里,546,149,397,4,550,1528,35.99,9.75
臺南市,北門區,保吉里,382,127,255,7,389,1309,29.72,9.7
臺南市,北門區,雙春里,146,47,99,3,149,451,33.04,10.42
臺南市,北門區,北門里,271,101,170,1,272,820,33.17,12.32
臺南市,北門區,錦湖里,249,90,159,2,251,909,27.61,9.9
臺南市,北門區,三光里,396,140,256,4,400,1152,34.72,12.15
臺南市,北門區,玉港里,242,61,181,5,247,702,35.19,8.69
臺南市,北門區,慈安里,199,58,141,2,201,726,27.69,7.99
臺南市,北門區,永隆里,281,102,179,4,285,843,33.81,12.1
臺南市,北門區,蚵寮里,430,137,293,2,432,1415,30.53,9.68
臺南市,北門區,文山里,433,111,322,7,440,1222,36.01,9.08
臺南市,新化區,武安里,1351,581,770,12,1363,3038,44.87,19.12
臺南市,新化區,東榮里,1579,656,923,14,1593,3973,40.1,16.51
臺南市,新化區,護國里,1078,421,657,10,1088,2724,39.94,15.46
臺南市,新化區,太平里,1832,703,1129,17,1849,4411,41.92,15.94
臺南市,新化區,協興里,1281,487,794,19,1300,3203,40.59,15.2
臺南市,新化區,唪口里,853,289,564,8,861,2153,39.99,13.42
臺南市,新化區,北勢里,560,195,365,6,566,1482,38.19,13.16
臺南市,新化區,豐榮里,1201,501,700,19,1220,3226,37.82,15.53
臺南市,新化區,全興里,1090,462,628,15,1105,2804,39.41,16.48
臺南市,新化區,崙頂里,851,260,591,7,858,2123,40.41,12.25
臺南市,新化區,知義里,832,306,526,10,842,2155,39.07,14.2
臺南市,新化區,山脚里,564,177,387,7,571,1679,34.01,10.54
臺南市,新化區,大坑里,160,36,124,2,162,425,38.12,8.47
臺南市,新化區,𦰡拔里,737,301,436,8,745,2087,35.7,14.42
臺南市,新化區,羊林里,355,136,219,2,357,899,39.71,15.13
臺南市,新化區,礁坑里,377,71,306,7,384,933,41.16,7.61
臺南市,善化區,東關里,434,170,264,10,444,1123,39.54,15.14
臺南市,善化區,坐駕里,1562,621,941,13,1575,3901,40.37,15.92
臺南市,善化區,光文里,2205,848,1357,24,2229,5414,41.17,15.66
臺南市,善化區,文昌里,1013,357,656,9,1022,2685,38.06,13.3
臺南市,善化區,南關里,735,231,504,5,740,1791,41.32,12.9
臺南市,善化區,文正里,626,203,423,5,631,1601,39.41,12.68
臺南市,善化區,胡家里,529,106,423,8,537,1235,43.48,8.58
臺南市,善化區,胡厝里,840,245,595,11,851,2010,42.34,12.19
臺南市,善化區,什乃里,496,146,350,2,498,1226,40.62,11.91
臺南市,善化區,溪美里,843,295,548,6,849,1944,43.67,15.17
臺南市,善化區,六分里,283,59,224,3,286,677,42.25,8.71
臺南市,善化區,六德里,392,97,295,5,397,1041,38.14,9.32
臺南市,善化區,田寮里,667,181,486,13,680,1684,40.38,10.75
臺南市,善化區,牛庄里,676,220,456,14,690,1608,42.91,13.68
臺南市,善化區,嘉北里,640,187,453,7,647,1587,40.77,11.78
臺南市,善化區,嘉南里,428,96,332,2,430,1068,40.26,8.99
臺南市,善化區,小新里,1676,603,1073,19,1695,4425,38.31,13.63
臺南市,善化區,頂街里,482,188,294,2,484,1117,43.33,16.83
臺南市,善化區,昌隆里,778,220,558,12,790,1945,40.62,11.31
臺南市,善化區,蓮潭里,1365,491,874,11,1376,3324,41.4,14.77
臺南市,新市區,新市里,1140,411,729,13,1153,2990,38.56,13.75
臺南市,新市區,新和里,2648,969,1679,29,2677,6488,41.26,14.94
臺南市,新市區,社內里,1114,336,778,6,1120,2768,40.46,12.14
臺南市,新市區,大洲里,313,87,226,5,318,714,44.54,12.18
臺南市,新市區,豐華里,317,94,223,3,320,870,36.78,10.8
臺南市,新市區,三舍里,607,197,410,6,613,1563,39.22,12.6
臺南市,新市區,大營里,1244,473,771,16,1260,3380,37.28,13.99
臺南市,新市區,大社里,1724,492,1232,16,1740,4530,38.41,10.86
臺南市,新市區,潭頂里,677,188,489,5,682,1790,38.1,10.5
臺南市,新市區,港墘里,1166,381,785,14,1180,3330,35.44,11.44
臺南市,新市區,永就里,1228,456,772,16,1244,2946,42.23,15.48
臺南市,安定區,蘇林里,906,264,642,18,924,2065,44.75,12.78
臺南市,安定區,蘇厝里,773,250,523,12,785,2038,38.52,12.27
臺南市,安定區,安定里,568,178,390,2,570,1381,41.27,12.89
臺南市,安定區,安加里,887,284,603,15,902,2194,41.11,12.94
臺南市,安定區,港尾里,585,182,403,7,592,1485,39.87,12.26
臺南市,安定區,中榮里,718,225,493,7,725,1715,42.27,13.12
臺南市,安定區,港口里,1188,402,786,13,1201,2901,41.4,13.86
臺南市,安定區,港南里,1092,316,776,11,1103,2658,41.5,11.89
臺南市,安定區,中沙里,317,105,212,0,317,715,44.34,14.69
臺南市,安定區,新吉里,976,299,677,8,984,2448,40.2,12.21
臺南市,安定區,海寮里,1033,334,699,13,1046,2574,40.64,12.98
臺南市,安定區,文科里,679,188,491,5,684,1609,42.51,11.68
臺南市,安定區,嘉同里,924,288,636,13,937,2380,39.37,12.1
臺南市,山上區,明和里,572,209,363,8,580,1662,34.9,12.58
臺南市,山上區,南洲里,642,214,428,9,651,1522,42.77,14.06
臺南市,山上區,山上里,338,125,213,9,347,961,36.11,13.01
臺南市,山上區,新莊里,301,88,213,6,307,930,33.01,9.46
臺南市,山上區,玉峯里,198,71,127,1,199,560,35.54,12.68
臺南市,山上區,平陽里,138,64,74,0,138,351,39.32,18.23
臺南市,山上區,豐德里,121,43,78,5,126,392,32.14,10.97
臺南市,玉井區,玉井里,450,243,207,4,454,1202,37.77,20.22
臺南市,玉井區,玉田里,1263,651,612,17,1280,3556,36.0,18.31
臺南市,玉井區,中正里,485,216,269,6,491,1198,40.98,18.03
臺南市,玉井區,竹圍里,478,219,259,8,486,1398,34.76,15.67
臺南市,玉井區,沙田里,193,87,106,11,204,497,41.05,17.51
臺南市,玉井區,三埔里,176,64,112,1,177,490,36.12,13.06
臺南市,玉井區,三和里,291,119,172,4,295,731,40.36,16.28
臺南市,玉井區,望明里,497,217,280,4,501,1428,35.08,15.2
臺南市,玉井區,層林里,203,75,128,5,208,580,35.86,12.93
臺南市,玉井區,豐里里,316,135,181,8,324,945,34.29,14.29
臺南市,楠西區,楠西里,585,334,251,9,594,1779,33.39,18.77
臺南市,楠西區,灣丘里,291,131,160,3,294,1071,27.45,12.23
臺南市,楠西區,密枝里,201,100,101,3,204,681,29.96,14.68
臺南市,楠西區,照興里,306,129,177,2,308,951,32.39,13.56
臺南市,楠西區,鹿田里,313,176,137,4,317,894,35.46,19.69
臺南市,楠西區,龜丹里,204,93,111,4,208,639,32.55,14.55
臺南市,楠西區,東勢里,729,372,357,10,739,2215,33.36,16.79
臺南市,南化區,南化里,536,227,309,10,546,1343,40.66,16.9
臺南市,南化區,小崙里,216,96,120,3,219,764,28.66,12.57
臺南市,南化區,中坑里,116,53,63,3,119,404,29.46,13.12
臺南市,南化區,北平里,202,74,128,3,205,547,37.48,13.53
臺南市,南化區,東和里,175,71,104,1,176,620,28.39,11.45
臺南市,南化區,西埔里,210,98,112,1,211,725,29.1,13.52
臺南市,南化區,北寮里,345,179,166,2,347,1130,30.71,15.84
臺南市,南化區,玉山里,308,140,168,6,314,1027,30.57,13.63
臺南市,南化區,關山里,181,106,75,4,185,948,19.51,11.18
臺南市,左鎮區,光和里,125,54,71,1,126,359,35.1,15.04
臺南市,左鎮區,榮和里,226,71,155,5,231,612,37.75,11.6
臺南市,左鎮區,左鎮里,157,51,106,5,162,456,35.53,11.18
臺南市,左鎮區,中正里,233,115,118,3,236,717,32.91,16.04
臺南市,左鎮區,睦光里,115,48,67,6,121,333,36.34,14.41
臺南市,左鎮區,內庄里,149,69,80,2,151,355,42.54,19.44
臺南市,左鎮區,澄山里,163,34,129,7,170,488,34.84,6.97
臺南市,左鎮區,岡林里,137,44,93,0,137,407,33.66,10.81
臺南市,左鎮區,草山里,94,36,58,4,98,286,34.27,12.59
臺南市,左鎮區,二寮里,89,21,68,1,90,179,50.28,11.73
臺南市,仁德區,太子里,2399,690,1709,24,2423,5421,44.7,12.73
臺南市,仁德區,土庫里,1247,328,919,15,1262,2737,46.11,11.98
臺南市,仁德區,一甲里,1111,406,705,13,1124,2570,43.74,15.8
臺南市,仁德區,仁德里,3047,1225,1822,26,3073,7630,40.28,16.06
臺南市,仁德區,仁義里,3923,1491,2432,29,3952,9033,43.75,16.51
臺南市,仁德區,新田里,1469,505,964,10,1479,3381,43.74,14.94
臺南市,仁德區,後壁里,3800,1364,2436,26,3826,9317,41.06,14.64
臺南市,仁德區,上崙里,2348,783,1565,31,2379,6025,39.49,13.0
臺南市,仁德區,保安里,1078,373,705,10,1088,2705,40.22,13.79
臺南市,仁德區,成功里,2107,1095,1012,25,2132,4809,44.33,22.77
臺南市,仁德區,仁和里,686,551,135,13,699,1493,46.82,36.91
臺南市,仁德區,仁愛里,530,286,244,3,533,1211,44.01,23.62
臺南市,仁德區,二行里,815,297,518,10,825,2102,39.25,14.13
臺南市,仁德區,大甲里,881,275,606,14,895,2110,42.42,13.03
臺南市,仁德區,中洲里,1071,350,721,18,1089,2612,41.69,13.4
臺南市,仁德區,文賢里,922,316,606,12,934,2215,42.17,14.27
臺南市,歸仁區,南保里,2432,809,1623,15,2447,5856,41.79,13.81
臺南市,歸仁區,六甲里,1379,418,961,9,1388,3838,36.16,10.89
臺南市,歸仁區,歸仁里,920,358,562,13,933,2285,40.83,15.67
臺南市,歸仁區,後市里,1343,440,903,11,1354,3225,41.98,13.64
臺南市,歸仁區,辜厝里,1340,478,862,8,1348,3248,41.5,14.72
臺南市,歸仁區,許厝里,1319,447,872,17,1336,3254,41.06,13.74
臺南市,歸仁區,看西里,926,299,627,13,939,2155,43.57,13.87
臺南市,歸仁區,看東里,764,273,491,8,772,1781,43.35,15.33
臺南市,歸仁區,崙頂里,1358,445,913,15,1373,3017,45.51,14.75
臺南市,歸仁區,沙崙里,277,89,188,2,279,692,40.32,12.86
臺南市,歸仁區,大潭里,746,211,535,6,752,1871,40.19,11.28
臺南市,歸仁區,武東里,646,223,423,5,651,1767,36.84,12.62
臺南市,歸仁區,八甲里,1182,402,780,5,1187,2678,44.32,15.01
臺南市,歸仁區,七甲里,1407,473,934,20,1427,3293,43.33,14.36
臺南市,歸仁區,媽廟里,843,243,600,10,853,1938,44.01,12.54
臺南市,歸仁區,西埔里,739,215,524,6,745,1652,45.1,13.01
臺南市,歸仁區,大廟里,1280,421,859,7,1287,3037,42.38,13.86
臺南市,歸仁區,南興里,1773,627,1146,14,1787,4221,42.34,14.85
臺南市,歸仁區,新厝里,967,301,666,7,974,2447,39.8,12.3
臺南市,歸仁區,歸南里,961,316,645,5,966,2218,43.55,14.25
臺南市,歸仁區,文化里,1218,437,781,15,1233,2952,41.77,14.8
臺南市,關廟區,關廟里,957,324,633,22,979,2249,43.53,14.41
臺南市,關廟區,山西里,853,256,597,7,860,2011,42.76,12.73
臺南市,關廟區,香洋里,1436,526,910,13,1449,3209,45.15,16.39
臺南市,關廟區,北勢里,1037,313,724,18,1055,2473,42.66,12.66
臺南市,關廟區,新埔里,370,102,268,5,375,1038,36.13,9.83
臺南市,關廟區,新光里,286,84,202,0,286,695,41.15,12.09
臺南市,關廟區,五甲里,1270,446,824,12,1282,3182,40.29,14.02
臺南市,關廟區,東勢里,1207,399,808,18,1225,3141,39.0,12.7
臺南市,關廟區,松腳里,753,224,529,11,764,1949,39.2,11.49
臺南市,關廟區,深坑里,593,209,384,5,598,1468,40.74,14.24
臺南市,關廟區,布袋里,471,128,343,10,481,1183,40.66,10.82
臺南市,關廟區,埤頭里,773,223,550,6,779,1936,40.24,11.52
臺南市,關廟區,下湖里,204,74,130,5,209,470,44.47,15.74
臺南市,關廟區,花園里,1386,423,963,12,1398,3442,40.62,12.29
臺南市,關廟區,南雄里,607,170,437,5,612,1494,40.96,11.38
臺南市,龍崎區,崎頂里,373,123,250,7,380,990,38.38,12.42
臺南市,龍崎區,土崎里,209,60,149,4,213,601,35.44,9.98
臺南市,龍崎區,中坑里,53,19,34,0,53,152,34.87,12.5
臺南市,龍崎區,楠坑里,159,56,103,1,160,371,43.13,15.09
臺南市,龍崎區,牛埔里,128,50,78,2,130,300,43.33,16.67
臺南市,龍崎區,大坪里,125,63,62,1,126,286,44.06,22.03
臺南市,龍崎區,龍船里,120,67,53,2,122,416,29.33,16.11
臺南市,龍崎區,石𥕢里,135,47,88,3,138,429,32.17,10.96
臺南市,永康區,五王里,2208,898,1310,16,2224,5645,39.4,15.91
臺南市,永康區,網寮里,2737,1059,1678,28,2765,6942,39.83,15.25
臺南市,永康區,永康里,3078,1204,1874,18,3096,8806,35.16,13.67
臺南市,永康區,埔園里,2853,1028,1825,25,2878,7154,40.23,14.37
臺南市,永康區,大橋里,2336,1001,1335,16,2352,5595,42.04,17.89
臺南市,永康區,王行里,1005,304,701,9,1014,2455,41.3,12.38
臺南市,永康區,烏竹里,1089,400,689,11,1100,2791,39.41,14.33
臺南市,永康區,蔦松里,708,222,486,5,713,1847,38.6,12.02
臺南市,永康區,三民里,651,241,410,10,661,1503,43.98,16.03
臺南市,永康區,塩行里,2062,678,1384,15,2077,4855,42.78,13.96
臺南市,永康區,甲頂里,983,300,683,5,988,2226,44.38,13.48
臺南市,永康區,大灣里,1415,411,1004,9,1424,3408,41.78,12.06
臺南市,永康區,東灣里,1425,414,1011,19,1444,3440,41.98,12.03
臺南市,永康區,西灣里,2999,1059,1940,25,3024,7237,41.79,14.63
臺南市,永康區,南灣里,1559,460,1099,12,1571,3833,40.99,12.0
臺南市,永康區,崑山里,2521,863,1658,23,2544,5820,43.71,14.83
臺南市,永康區,北灣里,1651,540,1111,15,1666,4081,40.82,13.23
臺南市,永康區,新樹里,823,271,552,9,832,2121,39.23,12.78
臺南市,永康區,復興里,705,479,226,13,718,1919,37.42,24.96
臺南市,永康區,復國里,3318,1695,1623,24,3342,8455,39.53,20.05
臺南市,永康區,建國里,768,464,304,15,783,1905,41.1,24.36
臺南市,永康區,神洲里,465,240,225,6,471,1264,37.26,18.99
臺南市,永康區,西勢里,2419,849,1570,31,2450,6123,40.01,13.87
臺南市,永康區,成功里,835,582,253,13,848,2032,41.73,28.64
臺南市,永康區,中興里,1385,694,691,12,1397,3317,42.12,20.92
臺南市,永康區,勝利里,2960,1448,1512,29,2989,7661,39.02,18.9
臺南市,永康區,龍潭里,2299,718,1581,20,2319,6139,37.77,11.7
臺南市,永康區,光復里,196,138,58,1,197,527,37.38,26.19
臺南市,永康區,塩洲里,2379,969,1410,17,2396,5686,42.14,17.04
臺南市,永康區,二王里,3144,1457,1687,33,3177,7749,41.0,18.8
臺南市,永康區,六合里,2251,987,1264,13,2264,5449,41.55,18.11
臺南市,永康區,三合里,1396,606,790,12,1408,3456,40.74,17.53
臺南市,永康區,東橋里,2798,1081,1717,20,2818,7184,39.23,15.05
臺南市,永康區,安康里,1867,766,1101,13,1880,4806,39.12,15.94
臺南市,永康區,西橋里,1241,478,763,12,1253,3018,41.52,15.84
臺南市,永康區,尚頂里,1642,547,1095,13,1655,3737,44.29,14.64
臺南市,永康區,復華里,3639,1792,1847,30,3669,9242,39.7,19.39
臺南市,永康區,正強里,3030,1124,1906,19,3049,7578,40.23,14.83
臺南市,永康區,中華里,1329,674,655,12,1341,2787,48.12,24.18
臺南市,永康區,北興里,2035,773,1262,18,2053,4977,41.25,15.53
臺南市,永康區,龍埔里,1450,541,909,13,1463,3732,39.2,14.5
臺南市,永康區,永明里,1854,845,1009,21,1875,4598,40.78,18.38
臺南市,永康區,塩興里,1354,509,845,10,1364,3794,35.95,13.42
臺南市,東區,富裕里,962,377,585,8,970,2144,45.24,17.58
臺南市,東區,裕農里,1297,569,728,12,1309,2857,45.82,19.92
臺南市,東區,大智里,2803,1390,1413,18,2821,6524,43.24,21.31
臺南市,東區,崇學里,1282,537,745,16,1298,2838,45.74,18.92
臺南市,東區,泉南里,2061,841,1220,23,2084,4536,45.94,18.54
臺南市,東區,仁和里,1874,812,1062,16,1890,4489,42.1,18.09
臺南市,東區,後甲里,1182,480,702,17,1199,2816,42.58,17.05
臺南市,東區,東光里,2189,1033,1156,21,2210,4731,46.71,21.83
臺南市,東區,新東里,1154,548,606,5,1159,2370,48.9,23.12
臺南市,東區,中西里,1339,609,730,13,1352,2931,46.13,20.78
臺南市,東區,東安里,538,210,328,3,541,1309,41.33,16.04
臺南市,東區,崇明里,1823,875,948,10,1833,3981,46.04,21.98
臺南市,東區,自強里,2174,1004,1170,20,2194,5154,42.57,19.48
臺南市,東區,和平里,2107,872,1235,25,2132,5004,42.61,17.43
臺南市,東區,路東里,734,370,364,5,739,1574,46.95,23.51
臺南市,東區,大德里,652,280,372,6,658,1465,44.91,19.11
臺南市,東區,關聖里,2069,1009,1060,19,2088,4496,46.44,22.44
臺南市,東區,衛國里,651,287,364,8,659,1504,43.82,19.08
臺南市,東區,崇善里,2196,900,1296,17,2213,4969,44.54,18.11
臺南市,東區,富強里,1928,754,1174,23,1951,4395,44.39,17.16
臺南市,東區,圍下里,863,360,503,5,868,1797,48.3,20.03
臺南市,東區,小東里,1832,901,931,11,1843,4122,44.71,21.86
臺南市,東區,大學里,518,243,275,3,521,1038,50.19,23.41
臺南市,東區,龍山里,2151,940,1211,13,2164,4589,47.16,20.48
臺南市,東區,虎尾里,2270,942,1328,22,2292,5079,45.13,18.55
臺南市,東區,德高里,1412,542,870,14,1426,3195,44.63,16.96
臺南市,東區,莊敬里,1552,742,810,8,1560,3480,44.83,21.32
臺南市,東區,大福里,727,300,427,8,735,1609,45.68,18.65
臺南市,東區,忠孝里,1933,932,1001,24,1957,4148,47.18,22.47
臺南市,東區,崇誨里,1107,569,538,6,1113,2346,47.44,24.25
臺南市,東區,東明里,1341,616,725,9,1350,2853,47.32,21.59
臺南市,東區,崇德里,2067,967,1100,20,2087,4400,47.43,21.98
臺南市,東區,東智里,1200,546,654,11,1211,2747,44.08,19.88
臺南市,東區,東聖里,924,383,541,15,939,2206,42.57,17.36
臺南市,東區,崇成里,1269,583,686,10,1279,2925,43.73,19.93
臺南市,東區,東門里,832,332,500,10,842,1800,46.78,18.44
臺南市,東區,成大里,834,401,433,5,839,1924,43.61,20.84
臺南市,東區,大同里,1240,534,706,14,1254,2848,44.03,18.75
臺南市,東區,德光里,1878,864,1014,13,1891,3861,48.98,22.38
臺南市,東區,崇信里,1553,618,935,15,1568,4399,35.64,14.05
臺南市,東區,崇文里,2590,1244,1346,15,2605,5808,44.85,21.42
臺南市,東區,復興里,1461,563,898,19,1480,3284,45.07,17.14
臺南市,東區,裕聖里,2108,1079,1029,16,2124,4654,45.64,23.18
臺南市,東區,南聖里,1129,530,599,11,1140,2522,45.2,21.02
臺南市,東區,文聖里,1954,919,1035,24,1978,4275,46.27,21.5
臺南市,南區,竹溪里,822,394,428,7,829,1623,51.08,24.28
臺南市,南區,明德里,546,272,274,6,552,1383,39.91,19.67
臺南市,南區,大成里,798,345,453,3,801,1753,45.69,19.68
臺南市,南區,廣州里,1077,364,713,11,1088,2226,48.88,16.35
臺南市,南區,新昌里,951,367,584,11,962,2173,44.27,16.89
臺南市,南區,新興里,1246,476,770,11,1257,2697,46.61,17.65
臺南市,南區,田寮里,1376,548,828,8,1384,3096,44.7,17.7
臺南市,南區,國宅里,1241,417,824,4,1245,2875,43.3,14.5
臺南市,南區,光明里,1768,558,1210,21,1789,4140,43.21,13.48
臺南市,南區,明亮里,1586,543,1043,15,1601,3510,45.61,15.47
臺南市,南區,喜東里,904,239,665,6,910,2071,43.94,11.54
臺南市,南區,喜北里,954,224,730,8,962,2143,44.89,10.45
臺南市,南區,喜南里,543,110,433,3,546,1191,45.84,9.24
臺南市,南區,省躬里,1479,416,1063,8,1487,3849,38.63,10.81
臺南市,南區,興農里,1097,311,786,11,1108,2639,41.99,11.78
臺南市,南區,同安里,944,274,670,4,948,2169,43.71,12.63
臺南市,南區,佛壇里,1055,262,793,8,1063,2471,43.02,10.6
臺南市,南區,大林里,1040,538,502,7,1047,2187,47.87,24.6
臺南市,南區,大忠里,2012,888,1124,20,2032,4438,45.79,20.01
臺南市,南區,大恩里,1456,661,795,12,1468,3368,43.59,19.63
臺南市,南區,新生里,1506,1054,452,14,1520,3347,45.41,31.49
臺南市,南區,再興里,1055,386,669,4,1059,2222,47.66,17.37
臺南市,南區,明興里,1433,410,1023,12,1445,3277,44.1,12.51
臺南市,南區,文華里,1479,566,913,14,1493,3213,46.47,17.62
臺南市,南區,金華里,2118,780,1338,21,2139,4948,43.23,15.76
臺南市,南區,南都里,930,345,585,13,943,2683,35.15,12.86
臺南市,南區,開南里,2365,863,1502,17,2382,5627,42.33,15.34
臺南市,南區,彰南里,658,217,441,3,661,1531,43.17,14.17
臺南市,南區,建南里,2313,753,1560,13,2326,5014,46.39,15.02
臺南市,南區,郡南里,1550,551,999,26,1576,3483,45.25,15.82
臺南市,南區,府南里,1928,719,1209,18,1946,4744,41.02,15.16
臺南市,南區,文南里,2274,879,1395,18,2292,4978,46.04,17.66
臺南市,南區,鯤鯓里,687,238,449,6,693,1717,40.36,13.86
臺南市,南區,松安里,815,209,606,8,823,1752,46.97,11.93
臺南市,南區,永寧里,768,204,564,11,779,1700,45.82,12.0
臺南市,南區,南華里,980,349,631,6,986,2425,40.66,14.39
臺南市,南區,鹽埕里,1678,530,1148,9,1687,3641,46.33,14.56
臺南市,北區,開元里,1446,617,829,12,1458,3350,43.52,18.42
臺南市,北區,東興里,932,495,437,9,941,1911,49.24,25.9
臺南市,北區,力行里,1091,536,555,10,1101,2358,46.69,22.73
臺南市,北區,振興里,872,351,521,10,882,1929,45.72,18.2
臺南市,北區,仁愛里,1089,488,601,9,1098,2173,50.53,22.46
臺南市,北區,大豐里,1680,575,1105,12,1692,4183,40.45,13.75
臺南市,北區,重興里,880,426,454,7,887,1829,48.5,23.29
臺南市,北區,和順里,2200,895,1305,16,2216,4751,46.64,18.84
臺南市,北區,正覺里,1381,454,927,14,1395,3128,44.6,14.51
臺南市,北區,成功里,1934,682,1252,9,1943,4481,43.36,15.22
臺南市,北區,文元里,1440,542,898,14,1454,3391,42.88,15.98
臺南市,北區,大港里,2369,902,1467,18,2387,5281,45.2,17.08
臺南市,北區,中樓里,652,272,380,8,660,1388,47.55,19.6
臺南市,北區,公園里,811,396,415,14,825,1809,45.61,21.89
臺南市,北區,元寶里,1596,732,864,12,1608,4041,39.79,18.11
臺南市,北區,永祥里,1352,571,781,18,1370,3012,45.48,18.96
臺南市,北區,成德里,1897,800,1097,21,1918,4329,44.31,18.48
臺南市,北區,文成里,1329,493,836,5,1334,2933,45.48,16.81
臺南市,北區,大和里,1550,472,1078,11,1561,3603,43.33,13.1
臺南市,北區,賢北里,1643,596,1047,16,1659,3566,46.52,16.71
臺南市,北區,長勝里,1703,1062,641,26,1729,3781,45.73,28.09
臺南市,北區,合興里,1541,664,877,8,1549,3378,45.86,19.66
臺南市,北區,北門里,2190,974,1216,21,2211,5163,42.82,18.87
臺南市,北區,小北里,1586,613,973,22,1608,3826,42.03,16.02
臺南市,北區,大光里,2035,1219,816,19,2054,4747,43.27,25.68
臺南市,北區,大興里,1261,525,736,13,1274,2929,43.5,17.92
臺南市,北區,長興里,1128,434,694,7,1135,2655,42.75,16.35
臺南市,北區,北華里,1463,544,919,9,1472,3987,36.92,13.64
臺南市,北區,華德里,1557,605,952,15,1572,3631,43.29,16.66
臺南市,北區,福德里,1949,805,1144,17,1966,4418,44.5,18.22
臺南市,北區,立人里,1112,387,725,8,1120,2467,45.4,15.69
臺南市,北區,雙安里,1015,414,601,9,1024,2258,45.35,18.33
臺南市,北區,元美里,1324,508,816,15,1339,2999,44.65,16.94
臺南市,安南區,東和里,1134,396,738,10,1144,2798,40.89,14.15
臺南市,安南區,安順里,1904,679,1225,22,1926,4730,40.72,14.36
臺南市,安南區,󻕯南里,1797,596,1201,13,1810,4668,38.77,12.77
臺南市,安南區,州南里,1973,672,1301,18,1991,5017,39.69,13.39
臺南市,安南區,州北里,1815,592,1223,12,1827,4446,41.09,13.32
臺南市,安南區,安東里,1179,391,788,10,1189,2762,43.05,14.16
臺南市,安南區,安西里,1441,466,975,11,1452,3488,41.63,13.36
臺南市,安南區,頂安里,1871,580,1291,17,1888,4518,41.79,12.84
臺南市,安南區,安慶里,2499,806,1693,22,2521,6006,41.97,13.42
臺南市,安南區,新順里,2499,883,1616,14,2513,6119,41.07,14.43
臺南市,安南區,原佃里,865,307,558,7,872,2171,40.17,14.14
臺南市,安南區,總頭里,737,230,507,8,745,1811,41.14,12.7
臺南市,安南區,長安里,1840,581,1259,7,1847,4706,39.25,12.35
臺南市,安南區,公親里,459,129,330,3,462,1148,40.24,11.24
臺南市,安南區,海東里,2003,601,1402,9,2012,5528,36.4,10.87
臺南市,安南區,海西里,1089,373,716,8,1097,2803,39.14,13.31
臺南市,安南區,海南里,1005,320,685,5,1010,2365,42.71,13.53
臺南市,安南區,溪心里,2670,928,1742,28,2698,7823,34.49,11.86
臺南市,安南區,塩田里,649,281,368,10,659,1587,41.52,17.71
臺南市,安南區,淵東里,1717,550,1167,14,1731,4730,36.6,11.63
臺南市,安南區,淵西里,1146,372,774,12,1158,3591,32.25,10.36
臺南市,安南區,佃東里,1196,400,796,7,1203,3358,35.82,11.91
臺南市,安南區,佃西里,716,236,480,5,721,2107,34.22,11.2
臺南市,安南區,公󻕯里,447,144,303,3,450,1031,43.65,13.97
臺南市,安南區,南興里,643,153,490,10,653,1831,35.66,8.36
臺南市,安南區,學東里,792,239,553,11,803,2484,32.33,9.62
臺南市,安南區,城東里,526,190,336,3,529,1572,33.65,12.09
臺南市,安南區,城北里,589,154,435,7,596,1569,37.99,9.82
臺南市,安南區,城中里,400,151,249,5,405,1050,38.57,14.38
臺南市,安南區,城南里,1136,345,791,15,1151,3209,35.87,10.75
臺南市,安南區,城西里,505,132,373,6,511,1442,35.44,9.15
臺南市,安南區,青草里,451,135,316,5,456,1507,30.26,8.96
臺南市,安南區,砂崙里,505,144,361,7,512,1292,39.63,11.15
臺南市,安南區,鹿耳里,279,112,167,6,285,888,32.09,12.61
臺南市,安南區,四草里,739,269,470,4,743,1882,39.48,14.29
臺南市,安南區,安和里,893,253,640,5,898,2122,42.32,11.92
臺南市,安南區,溪北里,1213,424,789,11,1224,2749,44.53,15.42
臺南市,安南區,溪頂里,1885,666,1219,12,1897,4392,43.19,15.16
臺南市,安南區,溪墘里,1238,362,876,12,1250,3015,41.46,12.01
臺南市,安南區,海佃里,1794,510,1284,17,1811,4278,42.33,11.92
臺南市,安南區,幸福里,1558,431,1127,14,1572,3596,43.72,11.99
臺南市,安南區,鳳凰里,1662,589,1073,8,1670,4402,37.94,13.38
臺南市,安南區,梅花里,1618,567,1051,12,1630,4025,40.5,14.09
臺南市,安南區,理想里,1902,558,1344,18,1920,4467,42.98,12.49
臺南市,安南區,溪東里,1626,600,1026,7,1633,3943,41.42,15.22
臺南市,安南區,淵中里,1256,387,869,13,1269,3321,38.21,11.65
臺南市,安南區,布袋里,579,189,390,4,583,1480,39.39,12.77
臺南市,安南區,國安里,1147,362,785,9,1156,2718,42.53,13.32
臺南市,安南區,安富里,2060,648,1412,23,2083,5393,38.62,12.02
臺南市,安南區,大安里,1453,475,978,10,1463,3607,40.56,13.17
臺南市,安南區,媽祖宮里,481,190,291,5,486,1456,33.38,13.05
臺南市,安平區,金城里,824,362,462,5,829,2012,41.2,17.99
臺南市,安平區,漁光里,197,66,131,3,200,435,45.98,15.17
臺南市,安平區,建平里,2092,811,1281,16,2108,5116,41.2,15.85
臺南市,安平區,怡平里,1676,697,979,14,1690,4196,40.28,16.61
臺南市,安平區,華平里,2006,810,1196,21,2027,4827,41.99,16.78
臺南市,安平區,平通里,2716,1101,1615,15,2731,7232,37.76,15.22
臺南市,安平區,文平里,2254,945,1309,16,2270,5000,45.4,18.9
臺南市,安平區,國平里,3059,1276,1783,19,3078,7593,40.54,16.8
臺南市,安平區,育平里,2956,1321,1635,27,2983,7951,37.52,16.61
臺南市,安平區,億載里,1306,503,803,10,1316,3031,43.42,16.6
臺南市,安平區,平安里,1450,521,929,8,1458,3301,44.17,15.78
臺南市,安平區,天妃里,1380,454,926,15,1395,3261,42.78,13.92
臺南市,安平區,王城里,1080,374,706,9,1089,2761,39.44,13.55
臺南市,中西區,赤嵌里,1660,572,1088,8,1668,3653,45.66,15.66
臺南市,中西區,郡王里,1328,554,774,9,1337,3036,44.04,18.25
臺南市,中西區,法華里,1235,551,684,12,1247,2678,46.56,20.58
臺南市,中西區,開山里,1004,354,650,6,1010,2406,41.98,14.71
臺南市,中西區,永華里,1132,427,705,12,1144,2516,45.47,16.97
臺南市,中西區,藥王里,1470,507,963,12,1482,3287,45.09,15.42
臺南市,中西區,光賢里,1616,554,1062,17,1633,3479,46.94,15.92
臺南市,中西區,大涼里,1123,433,690,10,1133,2515,45.05,17.22
臺南市,中西區,西湖里,2631,1100,1531,22,2653,5665,46.83,19.42
臺南市,中西區,西賢里,2332,913,1419,13,2345,4932,47.55,18.51
臺南市,中西區,城隍里,1653,586,1067,8,1661,3667,45.3,15.98
臺南市,中西區,南美里,1375,477,898,2,1377,3143,43.81,15.18
臺南市,中西區,南門里,1181,545,636,5,1186,2478,47.86,21.99
臺南市,中西區,小西門里,1347,576,771,8,1355,3070,44.14,18.76
臺南市,中西區,五條港里,871,311,560,9,880,1972,44.62,15.77
臺南市,中西區,兌悅里,1567,499,1068,19,1586,3846,41.24,12.97
臺南市,中西區,淺草里,1067,378,689,6,1073,2485,43.18,15.21
臺南市,中西區,府前里,828,288,540,8,836,1878,44.52,15.34
臺南市,中西區,南廠里,1702,574,1128,9,1711,3913,43.73,14.67
臺南市,中西區,西和里,1773,682,1091,16,1789,3847,46.5,17.73
高雄市,鹽埕區,藍橋里,630,205,425,3,633,1261,50.2,16.26
高雄市,鹽埕區,慈愛里,154,48,106,2,156,321,48.6,14.95
高雄市,鹽埕區,博愛里,328,106,222,3,331,626,52.88,16.93
高雄市,鹽埕區,壽星里,537,243,294,9,546,1222,44.68,19.89
高雄市,鹽埕區,中山里,597,245,352,6,603,1240,48.63,19.76
高雄市,鹽埕區,教仁里,929,357,572,7,936,1941,48.22,18.39
高雄市,鹽埕區,新樂里,416,170,246,0,416,805,51.68,21.12
高雄市,鹽埕區,中原里,301,99,202,1,302,569,53.08,17.4
高雄市,鹽埕區,光明里,577,189,388,8,585,1394,41.97,13.56
高雄市,鹽埕區,育仁里,360,136,224,3,363,733,49.52,18.55
高雄市,鹽埕區,河濱里,787,293,494,4,791,1581,50.03,18.53
高雄市,鹽埕區,沙地里,331,100,231,3,334,721,46.32,13.87
高雄市,鹽埕區,南端里,421,155,266,5,426,935,45.56,16.58
高雄市,鹽埕區,港都里,500,166,334,4,504,1042,48.37,15.93
高雄市,鹽埕區,江西里,488,170,318,2,490,1023,47.9,16.62
高雄市,鹽埕區,新豐里,378,158,220,3,381,775,49.16,20.39
高雄市,鹽埕區,府北里,864,319,545,4,868,1989,43.64,16.04
高雄市,鹽埕區,陸橋里,511,189,322,4,515,1114,46.23,16.97
高雄市,鹽埕區,瀨南里,279,99,180,0,279,547,51.01,18.1
高雄市,鹽埕區,新化里,271,100,171,4,275,543,50.64,18.42
高雄市,鹽埕區,江南里,261,49,212,3,264,569,46.4,8.61
高雄市,鼓山區,鼓峰里,846,473,373,6,852,1923,44.31,24.6
高雄市,鼓山區,雄峰里,824,552,272,7,831,1924,43.19,28.69
高雄市,鼓山區,前峰里,1945,983,962,17,1962,4040,48.56,24.33
高雄市,鼓山區,光榮里,1557,481,1076,11,1568,3318,47.26,14.5
高雄市,鼓山區,民族里,639,239,400,5,644,1257,51.23,19.01
高雄市,鼓山區,內惟里,485,142,343,3,488,1072,45.52,13.25
高雄市,鼓山區,建國里,1082,445,637,9,1091,2405,45.36,18.5
高雄市,鼓山區,忠正里,1552,617,935,10,1562,3652,42.77,16.89
高雄市,鼓山區,自強里,374,338,36,1,375,703,53.34,48.08
高雄市,鼓山區,龍井里,518,202,316,3,521,1210,43.06,16.69
高雄市,鼓山區,正德里,854,251,603,10,864,1928,44.81,13.02
高雄市,鼓山區,平和里,1604,532,1072,7,1611,3346,48.15,15.9
高雄市,鼓山區,民強里,1213,417,796,8,1221,2539,48.09,16.42
高雄市,鼓山區,厚生里,1353,461,892,11,1364,2970,45.93,15.52
高雄市,鼓山區,龍子里,6586,2954,3632,58,6644,15526,42.79,19.03
高雄市,鼓山區,龍水里,9772,4590,5182,58,9830,22850,43.02,20.09
高雄市,鼓山區,明誠里,6795,3397,3398,30,6825,16357,41.73,20.77
高雄市,鼓山區,華豐里,1643,842,801,14,1657,3836,43.2,21.95
高雄市,鼓山區,裕興里,1426,739,687,9,1435,3144,45.64,23.51
高雄市,鼓山區,裕豐里,1144,680,464,7,1151,2453,46.92,27.72
高雄市,鼓山區,鼓岩里,474,157,317,8,482,1125,42.84,13.96
高雄市,鼓山區,樹德里,565,169,396,4,569,1113,51.12,15.18
高雄市,鼓山區,寶樹里,520,188,332,4,524,1920,27.29,9.79
高雄市,鼓山區,興宗里,559,190,369,6,565,1241,45.53,15.31
高雄市,鼓山區,光化里,532,214,318,3,535,1207,44.32,17.73
高雄市,鼓山區,山下里,602,274,328,8,610,1306,46.71,20.98
高雄市,鼓山區,河邊里,560,230,330,2,562,1301,43.2,17.68
高雄市,鼓山區,綠川里,614,212,402,6,620,1361,45.55,15.58
高雄市,鼓山區,登山里,256,97,159,2,258,605,42.64,16.03
高雄市,鼓山區,峰南里,354,108,246,4,358,778,46.02,13.88
高雄市,鼓山區,麗興里,419,139,280,5,424,928,45.69,14.98
高雄市,鼓山區,新民里,421,117,304,2,423,955,44.29,12.25
高雄市,鼓山區,延平里,361,100,261,5,366,715,51.19,13.99
高雄市,鼓山區,維生里,579,194,385,2,581,1190,48.82,16.3
高雄市,鼓山區,惠安里,472,139,333,5,477,1102,43.28,12.61
高雄市,鼓山區,壽山里,524,144,380,8,532,1307,40.7,11.02
高雄市,鼓山區,哨船頭里,426,177,249,6,432,963,44.86,18.38
高雄市,鼓山區,桃源里,234,83,151,5,239,527,45.35,15.75
高雄市,左營區,進學里,648,312,336,5,653,2636,24.77,11.84
高雄市,左營區,尾西里,476,149,327,5,481,973,49.43,15.31
高雄市,左營區,頂北里,270,96,174,4,274,512,53.52,18.75
高雄市,左營區,中北里,298,61,237,6,304,603,50.41,10.12
高雄市,左營區,中南里,244,69,175,1,245,496,49.4,13.91
高雄市,左營區,廟東里,408,92,316,4,412,799,51.56,11.51
高雄市,左營區,廟北里,403,101,302,5,408,839,48.63,12.04
高雄市,左營區,尾南里,325,91,234,3,328,705,46.52,12.91
高雄市,左營區,尾北里,1404,540,864,10,1414,3265,43.31,16.54
高雄市,左營區,屏山里,637,440,197,15,652,1512,43.12,29.1
高雄市,左營區,祥和里,148,118,30,0,148,331,44.71,35.65
高雄市,左營區,永清里,189,135,54,2,191,600,31.83,22.5
高雄市,左營區,莒光里,731,436,295,4,735,1687,43.57,25.84
高雄市,左營區,光輝里,1026,528,498,12,1038,2403,43.2,21.97
高雄市,左營區,合群里,1243,1116,127,11,1254,2489,50.38,44.84
高雄市,左營區,明建里,289,197,92,2,291,611,47.63,32.24
高雄市,左營區,頂西里,445,105,340,5,450,907,49.61,11.58
高雄市,左營區,聖后里,366,100,266,3,369,711,51.9,14.06
高雄市,左營區,聖西里,156,46,110,0,156,329,47.42,13.98
高雄市,左營區,聖南里,253,75,178,2,255,522,48.85,14.37
高雄市,左營區,城南里,242,70,172,1,243,491,49.49,14.26
高雄市,左營區,路東里,367,106,261,2,369,690,53.48,15.36
高雄市,左營區,廍北里,191,35,156,6,197,391,50.38,8.95
高雄市,左營區,廍南里,296,94,202,0,296,575,51.48,16.35
高雄市,左營區,埤西里,405,165,240,1,406,842,48.22,19.6
高雄市,左營區,埤北里,559,339,220,9,568,1260,45.08,26.9
高雄市,左營區,埤東里,414,154,260,5,419,920,45.54,16.74
高雄市,左營區,海勝里,2711,2198,513,32,2743,5561,49.33,39.53
高雄市,左營區,崇實里,1349,777,572,8,1357,3147,43.12,24.69
高雄市,左營區,自助里,363,206,157,4,367,907,40.46,22.71
高雄市,左營區,果貿里,1266,1004,262,8,1274,2680,47.54,37.46
高雄市,左營區,果惠里,694,531,163,7,701,1445,48.51,36.75
高雄市,左營區,果峰里,663,521,142,6,669,1540,43.44,33.83
高雄市,左營區,新下里,5899,2884,3015,49,5948,13601,43.73,21.2
高雄市,左營區,新上里,10903,4645,6258,77,10980,25163,43.64,18.46
高雄市,左營區,新中里,2177,644,1533,20,2197,4725,46.5,13.63
高雄市,左營區,新光里,5751,2631,3120,35,5786,13461,42.98,19.55
高雄市,左營區,菜公里,11536,5220,6316,92,11628,28382,40.97,18.39
高雄市,左營區,福山里,13768,6658,7110,85,13853,35376,39.16,18.82
高雄市,楠梓區,清豐里,8657,3369,5288,72,8729,21636,40.34,15.57
高雄市,楠梓區,東寧里,1753,674,1079,11,1764,4264,41.37,15.81
高雄市,楠梓區,五常里,2365,852,1513,12,2377,6356,37.4,13.4
高雄市,楠梓區,享平里,1271,439,832,4,1275,3150,40.48,13.94
高雄市,楠梓區,中陽里,1327,421,906,17,1344,3252,41.33,12.95
高雄市,楠梓區,惠楠里,1045,394,651,5,1050,3163,33.2,12.46
高雄市,楠梓區,惠民里,1732,677,1055,18,1750,3884,45.06,17.43
高雄市,楠梓區,惠豐里,2017,1022,995,16,2033,4669,43.54,21.89
高雄市,楠梓區,錦屏里,1350,332,1018,17,1367,2830,48.3,11.73
高雄市,楠梓區,玉屏里,1019,221,798,13,1032,2059,50.12,10.73
高雄市,楠梓區,金田里,1668,440,1228,17,1685,3828,44.02,11.49
高雄市,楠梓區,稔田里,719,144,575,5,724,1375,52.65,10.47
高雄市,楠梓區,瑞屏里,1397,511,886,13,1410,3487,40.44,14.65
高雄市,楠梓區,翠屏里,6098,3117,2981,34,6132,16189,37.88,19.25
高雄市,楠梓區,宏南里,356,188,168,3,359,657,54.64,28.61
高雄市,楠梓區,宏毅里,1053,458,595,7,1060,2064,51.36,22.19
高雄市,楠梓區,宏榮里,1080,546,534,6,1086,2417,44.93,22.59
高雄市,楠梓區,廣昌里,1271,565,706,9,1280,2885,44.37,19.58
高雄市,楠梓區,久昌里,1066,492,574,7,1073,2765,38.81,17.79
高雄市,楠梓區,大昌里,773,364,409,8,781,2046,38.17,17.79
高雄市,楠梓區,福昌里,960,354,606,11,971,2023,48.0,17.5
高雄市,楠梓區,盛昌里,2316,1117,1199,15,2331,5347,43.59,20.89
高雄市,楠梓區,泰昌里,562,223,339,6,568,1397,40.66,15.96
高雄市,楠梓區,興昌里,1808,732,1076,14,1822,4314,42.23,16.97
高雄市,楠梓區,建昌里,1075,480,595,2,1077,2534,42.5,18.94
高雄市,楠梓區,宏昌里,1390,633,757,11,1401,3221,43.5,19.65
高雄市,楠梓區,和昌里,886,418,468,7,893,1997,44.72,20.93
高雄市,楠梓區,慶昌里,1537,727,810,7,1544,3122,49.46,23.29
高雄市,楠梓區,隆昌里,1392,651,741,13,1405,3235,43.43,20.12
高雄市,楠梓區,秀昌里,947,472,475,5,952,2104,45.25,22.43
高雄市,楠梓區,裕昌里,1855,758,1097,8,1863,4652,40.05,16.29
高雄市,楠梓區,國昌里,1430,599,831,8,1438,3394,42.37,17.65
高雄市,楠梓區,加昌里,3349,1713,1636,21,3370,8252,40.84,20.76
高雄市,楠梓區,仁昌里,1933,981,952,19,1952,4959,39.36,19.78
高雄市,楠梓區,藍田里,2976,1321,1655,22,2998,7507,39.94,17.6
高雄市,楠梓區,中興里,697,210,487,6,703,1558,45.12,13.48
高雄市,楠梓區,中和里,1432,490,942,12,1444,4154,34.76,11.8
高雄市,三民區,鼎金里,1549,544,1005,6,1555,3804,40.88,14.3
高雄市,三民區,鼎盛里,3014,1241,1773,16,3030,7370,41.11,16.84
高雄市,三民區,鼎強里,1620,600,1020,16,1636,3793,43.13,15.82
高雄市,三民區,鼎力里,1696,650,1046,11,1707,3884,43.95,16.74
高雄市,三民區,鼎西里,2839,1065,1774,14,2853,7030,40.58,15.15
高雄市,三民區,鼎中里,1586,523,1063,13,1599,3436,46.54,15.22
高雄市,三民區,鼎泰里,9171,4198,4973,78,9249,20899,44.26,20.09
高雄市,三民區,本館里,3534,1373,2161,21,3555,8380,42.42,16.38
高雄市,三民區,本和里,3033,1191,1842,24,3057,6992,43.72,17.03
高雄市,三民區,本文里,867,328,539,8,875,1915,45.69,17.13
高雄市,三民區,本武里,713,241,472,5,718,1561,46.0,15.44
高雄市,三民區,本元里,2193,871,1322,15,2208,4987,44.28,17.47
高雄市,三民區,本安里,1923,828,1095,14,1937,4277,45.29,19.36
高雄市,三民區,本上里,1972,878,1094,13,1985,4461,44.5,19.68
高雄市,三民區,本揚里,3225,1357,1868,21,3246,7143,45.44,19.0
高雄市,三民區,寶獅里,1621,658,963,8,1629,3486,46.73,18.88
高雄市,三民區,寶德里,2075,799,1276,15,2090,4824,43.33,16.56
高雄市,三民區,寶泰里,1521,554,967,15,1536,3831,40.09,14.46
高雄市,三民區,寶興里,2743,1060,1683,19,2762,6396,43.18,16.57
高雄市,三民區,寶中里,1220,436,784,13,1233,2807,43.93,15.53
高雄市,三民區,寶華里,1353,617,736,5,1358,3089,43.96,19.97
高雄市,三民區,寶國里,3194,1308,1886,29,3223,7514,42.89,17.41
高雄市,三民區,寶民里,1223,548,675,10,1233,3030,40.69,18.09
高雄市,三民區,寶慶里,1077,417,660,12,1089,2557,42.59,16.31
高雄市,三民區,寶業里,2432,966,1466,9,2441,5630,43.36,17.16
高雄市,三民區,寶盛里,2266,964,1302,15,2281,4748,48.04,20.3
高雄市,三民區,寶安里,2798,1232,1566,23,2821,6808,41.44,18.1
高雄市,三民區,寶龍里,1890,769,1121,13,1903,3982,47.79,19.31
高雄市,三民區,寶珠里,2264,880,1384,9,2273,6719,33.83,13.1
高雄市,三民區,寶玉里,3294,1385,1909,14,3308,7920,41.77,17.49
高雄市,三民區,灣子里,1504,606,898,9,1513,3836,39.44,15.8
高雄市,三民區,灣愛里,1014,339,675,12,1026,2898,35.4,11.7
高雄市,三民區,灣中里,2023,709,1314,11,2034,5297,38.4,13.38
高雄市,三民區,灣華里,1050,413,637,6,1056,2586,40.84,15.97
高雄市,三民區,灣勝里,771,213,558,8,779,1821,42.78,11.7
高雄市,三民區,灣利里,1427,411,1016,6,1433,3021,47.43,13.6
高雄市,三民區,灣復里,1382,539,843,8,1390,3493,39.79,15.43
高雄市,三民區,正興里,4708,1967,2741,42,4750,11804,40.24,16.66
高雄市,三民區,正順里,1674,679,995,10,1684,3743,44.99,18.14
高雄市,三民區,灣興里,802,276,526,5,807,1778,45.39,15.52
高雄市,三民區,灣成里,1013,392,621,9,1022,2499,40.9,15.69
高雄市,三民區,安康里,1028,347,681,6,1034,2682,38.55,12.94
高雄市,三民區,安寧里,770,272,498,14,784,1744,44.95,15.6
高雄市,三民區,安吉里,1844,764,1080,21,1865,4294,43.43,17.79
高雄市,三民區,安發里,1909,759,1150,14,1923,4233,45.43,17.93
高雄市,三民區,安東里,1412,471,941,9,1421,2893,49.12,16.28
高雄市,三民區,安和里,1157,386,771,13,1170,2309,50.67,16.72
高雄市,三民區,達德里,641,200,441,2,643,1208,53.23,16.56
高雄市,三民區,達明里,716,232,484,11,727,1482,49.06,15.65
高雄市,三民區,達仁里,663,219,444,3,666,1379,48.3,15.88
高雄市,三民區,達勇里,405,141,264,1,406,882,46.03,15.99
高雄市,三民區,同德里,1300,464,836,14,1314,2589,50.75,17.92
高雄市,三民區,德智里,989,382,607,7,996,2030,49.06,18.82
高雄市,三民區,德仁里,871,327,544,5,876,1812,48.34,18.05
高雄市,三民區,安生里,694,225,469,5,699,1339,52.2,16.8
高雄市,三民區,德東里,392,126,266,4,396,748,52.94,16.84
高雄市,三民區,德行里,570,192,378,3,573,1023,56.01,18.77
高雄市,三民區,精華里,696,243,453,5,701,1448,48.41,16.78
高雄市,三民區,民享里,1005,323,682,6,1011,1900,53.21,17.0
高雄市,三民區,安宜里,1466,488,978,9,1475,2953,49.95,16.53
高雄市,三民區,安泰里,1656,629,1027,20,1676,3633,46.13,17.31
高雄市,三民區,安邦里,1723,612,1111,11,1734,3606,48.09,16.97
高雄市,三民區,十全里,753,231,522,2,755,1671,45.18,13.82
高雄市,三民區,十美里,834,290,544,3,837,1690,49.53,17.16
高雄市,三民區,德北里,932,486,446,6,938,1992,47.09,24.4
高雄市,三民區,立誠里,335,103,232,4,339,659,51.44,15.63
高雄市,三民區,立業里,384,113,271,2,386,914,42.23,12.36
高雄市,三民區,港東里,591,207,384,3,594,1341,44.3,15.44
高雄市,三民區,港新里,626,250,376,5,631,1337,47.2,18.7
高雄市,三民區,港西里,333,121,212,3,336,760,44.21,15.92
高雄市,三民區,博愛里,539,215,324,4,543,1126,48.22,19.09
高雄市,三民區,博惠里,1840,708,1132,11,1851,3922,47.2,18.05
高雄市,三民區,長明里,424,185,239,2,426,1008,42.26,18.35
高雄市,三民區,建東里,446,194,252,5,451,1147,39.32,16.91
高雄市,三民區,興德里,863,360,503,7,870,1905,45.67,18.9
高雄市,三民區,鳳南里,457,128,329,6,463,886,52.26,14.45
高雄市,三民區,鳳北里,657,213,444,7,664,1307,50.8,16.3
高雄市,三民區,德西里,425,163,262,7,432,998,43.29,16.33
高雄市,三民區,豐裕里,972,334,638,8,980,2347,41.76,14.23
高雄市,三民區,川東里,529,189,340,2,531,1212,43.81,15.59
高雄市,三民區,裕民里,503,191,312,4,507,1226,41.35,15.58
高雄市,三民區,力行里,493,175,318,3,496,1046,47.42,16.73
高雄市,三民區,千歲里,577,231,346,7,584,1082,53.97,21.35
高雄市,三民區,立德里,554,220,334,5,559,1156,48.36,19.03
高雄市,三民區,千北里,458,159,299,5,463,1009,45.89,15.76
高雄市,三民區,千秋里,876,307,569,9,885,1967,44.99,15.61
高雄市,新興區,浩然里,837,403,434,3,840,1749,48.03,23.04
高雄市,新興區,振成里,483,215,268,3,486,1026,47.37,20.96
高雄市,新興區,德生里,1297,571,726,13,1310,2842,46.09,20.09
高雄市,新興區,振華里,494,221,273,2,496,1011,49.06,21.86
高雄市,新興區,正氣里,646,272,374,3,649,1282,50.62,21.22
高雄市,新興區,德政里,301,156,145,6,307,626,49.04,24.92
高雄市,新興區,仁聲里,419,165,254,2,421,979,43.0,16.85
高雄市,新興區,德望里,831,348,483,1,832,1808,46.02,19.25
高雄市,新興區,華聲里,406,150,256,3,409,902,45.34,16.63
高雄市,新興區,蕉園里,359,143,216,4,363,706,51.42,20.25
高雄市,新興區,永寧里,593,223,370,7,600,1289,46.55,17.3
高雄市,新興區,玉衡里,314,112,202,4,318,736,43.21,15.22
高雄市,新興區,順昌里,853,328,525,4,857,1998,42.89,16.42
高雄市,新興區,文昌里,1319,547,772,9,1328,2739,48.48,19.97
高雄市,新興區,光耀里,1053,462,591,7,1060,2197,48.25,21.03
高雄市,新興區,興昌里,781,348,433,10,791,1572,50.32,22.14
高雄市,新興區,開平里,1583,662,921,8,1591,3254,48.89,20.34
高雄市,新興區,成功里,589,287,302,1,590,1299,45.42,22.09
高雄市,新興區,新江里,454,158,296,6,460,1074,42.83,14.71
高雄市,新興區,黎明里,384,146,238,4,388,801,48.44,18.23
高雄市,新興區,愛平里,437,163,274,2,439,996,44.08,16.37
高雄市,新興區,南港里,983,333,650,13,996,1859,53.58,17.91
高雄市,新興區,中東里,1074,479,595,5,1079,2712,39.79,17.66
高雄市,新興區,明莊里,307,115,192,2,309,692,44.65,16.62
高雄市,新興區,大明里,477,177,300,2,479,1021,46.91,17.34
高雄市,新興區,秋山里,415,151,264,4,419,960,43.65,15.73
高雄市,新興區,長驛里,387,156,231,5,392,934,41.97,16.7
高雄市,新興區,建興里,385,126,259,2,387,919,42.11,13.71
高雄市,新興區,建華里,388,127,261,3,391,785,49.81,16.18
高雄市,新興區,漢民里,326,113,213,3,329,685,48.03,16.5
高雄市,新興區,榮治里,331,150,181,3,334,702,47.58,21.37
高雄市,新興區,東坡里,573,194,379,5,578,1152,50.17,16.84
高雄市,前金區,三川里,326,88,238,2,328,658,49.85,13.37
高雄市,前金區,草江里,486,222,264,5,491,983,49.95,22.58
高雄市,前金區,長城里,580,201,379,6,586,1310,44.73,15.34
高雄市,前金區,北金里,372,136,236,1,373,809,46.11,16.81
高雄市,前金區,東金里,472,165,307,2,474,957,49.53,17.24
高雄市,前金區,新生里,1620,720,900,15,1635,3581,45.66,20.11
高雄市,前金區,後金里,309,130,179,2,311,662,46.98,19.64
高雄市,前金區,長興里,532,222,310,3,535,1150,46.52,19.3
高雄市,前金區,青山里,810,323,487,13,823,1817,45.29,17.78
高雄市,前金區,民生里,351,152,199,1,352,778,45.24,19.54
高雄市,前金區,復元里,479,205,274,1,480,992,48.39,20.67
高雄市,前金區,林投里,403,138,265,3,406,1030,39.42,13.4
高雄市,前金區,國民里,409,158,251,5,414,901,45.95,17.54
高雄市,前金區,社東里,678,318,360,4,682,1424,47.89,22.33
高雄市,前金區,社西里,508,239,269,2,510,1017,50.15,23.5
高雄市,前金區,博孝里,466,196,270,1,467,986,47.36,19.88
高雄市,前金區,長生里,816,380,436,10,826,1640,50.37,23.17
高雄市,前金區,榮復里,487,205,282,4,491,1043,47.08,19.65
高雄市,前金區,文西里,446,160,286,7,453,941,48.14,17.0
高雄市,前金區,文東里,539,225,314,5,544,1108,49.1,20.31
高雄市,苓雅區,博仁里,339,159,180,2,341,681,50.07,23.35
高雄市,苓雅區,苓洲里,627,284,343,3,630,1496,42.11,18.98
高雄市,苓雅區,苓昇里,502,216,286,6,508,1147,44.29,18.83
高雄市,苓雅區,苓中里,701,270,431,13,714,1552,46.01,17.4
高雄市,苓雅區,苓雅里,601,270,331,10,611,1384,44.15,19.51
高雄市,苓雅區,苓東里,601,202,399,3,604,1405,42.99,14.38
高雄市,苓雅區,城北里,660,285,375,2,662,1540,42.99,18.51
高雄市,苓雅區,城西里,259,102,157,1,260,506,51.38,20.16
高雄市,苓雅區,城東里,799,331,468,7,806,1861,43.31,17.79
高雄市,苓雅區,意誠里,1382,654,728,12,1394,3663,38.06,17.85
高雄市,苓雅區,鼓中里,411,154,257,1,412,878,46.92,17.54
高雄市,苓雅區,田西里,604,254,350,9,613,1259,48.69,20.17
高雄市,苓雅區,人和里,723,281,442,4,727,1714,42.42,16.39
高雄市,苓雅區,仁政里,635,282,353,4,639,1191,53.65,23.68
高雄市,苓雅區,廣澤里,817,279,538,5,822,1686,48.75,16.55
高雄市,苓雅區,美田里,493,213,280,2,495,1085,45.62,19.63
高雄市,苓雅區,華堂里,1370,576,794,12,1382,2948,46.88,19.54
高雄市,苓雅區,日中里,999,400,599,5,1004,2080,48.27,19.23
高雄市,苓雅區,普照里,1384,559,825,11,1395,2971,46.95,18.82
高雄市,苓雅區,和煦里,897,388,509,7,904,1962,46.08,19.78
高雄市,苓雅區,晴朗里,752,332,420,6,758,2551,29.71,13.01
高雄市,苓雅區,普天里,1569,692,877,8,1577,3394,46.46,20.39
高雄市,苓雅區,林富里,1028,441,587,6,1034,2101,49.21,20.99
高雄市,苓雅區,林圍里,1058,507,551,8,1066,2233,47.74,22.7
高雄市,苓雅區,林安里,651,296,355,0,651,1434,45.4,20.64
高雄市,苓雅區,光華里,317,95,222,6,323,666,48.5,14.26
高雄市,苓雅區,林興里,556,170,386,3,559,1226,45.6,13.87
高雄市,苓雅區,林華里,1211,461,750,10,1221,2632,46.39,17.52
高雄市,苓雅區,林西里,663,278,385,4,667,1516,44.0,18.34
高雄市,苓雅區,林中里,1250,494,756,9,1259,2734,46.05,18.07
高雄市,苓雅區,林泉里,875,418,457,5,880,1845,47.7,22.66
高雄市,苓雅區,林南里,1307,673,634,7,1314,2771,47.42,24.29
高雄市,苓雅區,中正里,1266,564,702,12,1278,2724,46.92,20.7
高雄市,苓雅區,尚義里,693,295,398,7,700,1480,47.3,19.93
高雄市,苓雅區,同慶里,990,479,511,5,995,2090,47.61,22.92
高雄市,苓雅區,凱旋里,942,505,437,0,942,2096,44.94,24.09
高雄市,苓雅區,安祥里,1106,493,613,7,1113,2380,46.76,20.71
高雄市,苓雅區,奏捷里,710,328,382,7,717,1489,48.15,22.03
高雄市,苓雅區,福壽里,679,212,467,7,686,1389,49.39,15.26
高雄市,苓雅區,福南里,784,284,500,13,797,1620,49.2,17.53
高雄市,苓雅區,五權里,1094,496,598,10,1104,2086,52.92,23.78
高雄市,苓雅區,民主里,1733,712,1021,15,1748,3752,46.59,18.98
高雄市,苓雅區,林德里,836,384,452,0,836,1742,47.99,22.04
高雄市,苓雅區,林貴里,778,345,433,3,781,1748,44.68,19.74
高雄市,苓雅區,林榮里,1668,759,909,7,1675,3776,44.36,20.1
高雄市,苓雅區,英明里,816,301,515,6,822,1791,45.9,16.81
高雄市,苓雅區,林靖里,738,420,318,5,743,1489,49.9,28.21
高雄市,苓雅區,朝陽里,617,241,376,6,623,1371,45.44,17.58
高雄市,苓雅區,福隆里,1132,396,736,9,1141,2410,47.34,16.43
高雄市,苓雅區,福祥里,525,230,295,5,530,1158,45.77,19.86
高雄市,苓雅區,福海里,452,216,236,5,457,1023,44.67,21.11
高雄市,苓雅區,福康里,854,288,566,6,860,1787,48.13,16.12
高雄市,苓雅區,福人里,819,343,476,9,828,1974,41.95,17.38
高雄市,苓雅區,福地里,1073,428,645,6,1079,2537,42.53,16.87
高雄市,苓雅區,福居里,1065,363,702,3,1068,2583,41.35,14.05
高雄市,苓雅區,福東里,1095,451,644,6,1101,2521,43.67,17.89
高雄市,苓雅區,福西里,782,284,498,6,788,1685,46.77,16.85
高雄市,苓雅區,永康里,985,439,546,4,989,2051,48.22,21.4
高雄市,苓雅區,正文里,989,397,592,8,997,2240,44.51,17.72
高雄市,苓雅區,正言里,1201,511,690,8,1209,2641,45.78,19.35
高雄市,苓雅區,正大里,1993,945,1048,19,2012,4822,41.73,19.6
高雄市,苓雅區,五福里,1633,691,942,15,1648,3581,46.02,19.3
高雄市,苓雅區,正心里,1593,703,890,10,1603,3399,47.16,20.68
高雄市,苓雅區,正道里,1725,730,995,6,1731,4055,42.69,18.0
高雄市,苓雅區,正義里,1159,414,745,5,1164,2329,49.98,17.78
高雄市,苓雅區,正仁里,1006,449,557,6,1012,2409,42.01,18.64
高雄市,苓雅區,文昌里,1544,574,970,14,1558,3573,43.6,16.06
高雄市,苓雅區,建軍里,799,289,510,7,806,1945,41.44,14.86
高雄市,苓雅區,衛武里,887,422,465,3,890,1894,46.99,22.28
高雄市,前鎮區,草衙里,3581,1153,2428,39,3620,9285,38.99,12.42
高雄市,前鎮區,明孝里,974,308,666,14,988,2288,43.18,13.46
高雄市,前鎮區,明正里,2215,735,1480,23,2238,4994,44.81,14.72
高雄市,前鎮區,明義里,979,341,638,10,989,2203,44.89,15.48
高雄市,前鎮區,仁愛里,570,161,409,3,573,1263,45.37,12.75
高雄市,前鎮區,德昌里,732,279,453,7,739,1891,39.08,14.75
高雄市,前鎮區,平等里,851,275,576,12,863,2883,29.93,9.54
高雄市,前鎮區,平昌里,242,58,184,5,247,606,40.76,9.57
高雄市,前鎮區,明禮里,624,155,469,9,633,1420,44.58,10.92
高雄市,前鎮區,信義里,635,172,463,5,640,1365,46.89,12.6
高雄市,前鎮區,信德里,915,313,602,8,923,2203,41.9,14.21
高雄市,前鎮區,明道里,442,117,325,7,449,1033,43.47,11.33
高雄市,前鎮區,興化里,314,91,223,3,317,656,48.32,13.87
高雄市,前鎮區,興仁里,311,69,242,0,311,673,46.21,10.25
高雄市,前鎮區,前鎮里,599,175,424,5,604,1293,46.71,13.53
高雄市,前鎮區,鎮東里,831,240,591,5,836,1636,51.1,14.67
高雄市,前鎮區,鎮榮里,912,263,649,9,921,2041,45.12,12.89
高雄市,前鎮區,鎮昌里,856,263,593,8,864,1918,45.05,13.71
高雄市,前鎮區,鎮海里,1752,632,1120,12,1764,3979,44.33,15.88
高雄市,前鎮區,鎮陽里,398,151,247,5,403,902,44.68,16.74
高雄市,前鎮區,興邦里,1248,552,696,9,1257,2779,45.23,19.86
高雄市,前鎮區,鎮中里,365,124,241,2,367,802,45.76,15.46
高雄市,前鎮區,鎮北里,499,167,332,5,504,1077,46.8,15.51
高雄市,前鎮區,忠純里,2526,1741,785,24,2550,5166,49.36,33.7
高雄市,前鎮區,忠誠里,983,809,174,15,998,1970,50.66,41.07
高雄市,前鎮區,西山里,1467,664,803,8,1475,3261,45.23,20.36
高雄市,前鎮區,民權里,1926,966,960,13,1939,3898,49.74,24.78
高雄市,前鎮區,建隆里,583,255,328,9,592,1249,47.4,20.42
高雄市,前鎮區,振興里,1006,468,538,4,1010,2251,44.87,20.79
高雄市,前鎮區,良和里,1357,708,649,5,1362,2750,49.53,25.75
高雄市,前鎮區,西甲里,909,327,582,5,914,2053,44.52,15.93
高雄市,前鎮區,盛興里,1110,545,565,3,1113,2633,42.27,20.7
高雄市,前鎮區,盛豐里,1307,513,794,6,1313,2968,44.24,17.28
高雄市,前鎮區,興中里,1295,537,758,15,1310,2985,43.89,17.99
高雄市,前鎮區,興東里,2487,1074,1413,19,2506,5492,45.63,19.56
高雄市,前鎮區,忠孝里,1371,648,723,15,1386,2994,46.29,21.64
高雄市,前鎮區,復國里,1175,449,726,11,1186,2585,45.88,17.37
高雄市,前鎮區,竹內里,1242,419,823,11,1253,2634,47.57,15.91
高雄市,前鎮區,竹東里,923,361,562,4,927,2104,44.06,17.16
高雄市,前鎮區,竹南里,2890,1220,1670,18,2908,6665,43.63,18.3
高雄市,前鎮區,竹北里,1000,412,588,7,1007,2331,43.2,17.67
高雄市,前鎮區,竹西里,1830,779,1051,11,1841,3965,46.43,19.65
高雄市,前鎮區,竹中里,1523,628,895,19,1542,3340,46.17,18.8
高雄市,前鎮區,瑞竹里,645,219,426,5,650,1563,41.59,14.01
高雄市,前鎮區,瑞南里,1915,662,1253,11,1926,4567,42.17,14.5
高雄市,前鎮區,瑞豐里,1080,378,702,14,1094,2650,41.28,14.26
高雄市,前鎮區,瑞祥里,1892,724,1168,11,1903,4492,42.36,16.12
高雄市,前鎮區,瑞東里,938,292,646,7,945,2252,41.96,12.97
高雄市,前鎮區,瑞和里,789,253,536,5,794,1810,43.87,13.98
高雄市,前鎮區,瑞平里,1600,578,1022,13,1613,3473,46.44,16.64
高雄市,前鎮區,瑞隆里,1491,518,973,13,1504,3408,44.13,15.2
高雄市,前鎮區,瑞北里,1351,438,913,15,1366,3140,43.5,13.95
高雄市,前鎮區,瑞西里,1061,289,772,12,1073,2484,43.2,11.63
高雄市,前鎮區,瑞崗里,1141,386,755,5,1146,2474,46.32,15.6
高雄市,前鎮區,瑞興里,1080,327,753,7,1087,2446,44.44,13.37
高雄市,前鎮區,瑞誠里,1065,409,656,12,1077,2518,42.77,16.24
高雄市,前鎮區,瑞文里,987,294,693,7,994,2355,42.21,12.48
高雄市,前鎮區,瑞華里,1950,758,1192,19,1969,4394,44.81,17.25
高雄市,前鎮區,瑞昌里,1310,411,899,14,1324,3072,43.1,13.38
高雄市,旗津區,旗下里,510,141,369,5,515,1181,43.61,11.94
高雄市,旗津區,永安里,382,140,242,6,388,1056,36.74,13.26
高雄市,旗津區,振興里,618,179,439,10,628,1544,40.67,11.59
高雄市,旗津區,慈愛里,790,227,563,5,795,2240,35.49,10.13
高雄市,旗津區,復興里,993,408,585,8,1001,2922,34.26,13.96
高雄市,旗津區,中華里,640,171,469,1,641,1497,42.82,11.42
高雄市,旗津區,實踐里,501,310,191,12,513,1394,36.8,22.24
高雄市,旗津區,北汕里,868,287,581,10,878,2620,33.51,10.95
高雄市,旗津區,南汕里,779,186,593,9,788,2021,38.99,9.2
高雄市,旗津區,上竹里,1033,221,812,9,1042,2749,37.9,8.04
高雄市,旗津區,中洲里,743,190,553,2,745,1802,41.34,10.54
高雄市,旗津區,安順里,332,62,270,0,332,863,38.47,7.18
高雄市,旗津區,中興里,1011,251,760,8,1019,2457,41.47,10.22
高雄市,小港區,小港里,977,362,615,10,987,2204,44.78,16.42
高雄市,小港區,港口里,1376,628,748,5,1381,3080,44.84,20.39
高雄市,小港區,港正里,995,475,520,10,1005,2455,40.94,19.35
高雄市,小港區,港墘里,656,238,418,4,660,1658,39.81,14.35
高雄市,小港區,港明里,1122,394,728,8,1130,3006,37.59,13.11
高雄市,小港區,港后里,1085,385,700,10,1095,2482,44.12,15.51
高雄市,小港區,港南里,901,325,576,3,904,2715,33.3,11.97
高雄市,小港區,港興里,1013,367,646,7,1020,2209,46.17,16.61
高雄市,小港區,鳳宮里,991,316,675,8,999,2601,38.41,12.15
高雄市,小港區,店鎮里,2248,777,1471,18,2266,5620,40.32,13.83
高雄市,小港區,大苓里,1051,392,659,10,1061,2419,43.86,16.21
高雄市,小港區,二苓里,1417,446,971,6,1423,3563,39.94,12.52
高雄市,小港區,三苓里,1185,431,754,10,1195,2779,43.0,15.51
高雄市,小港區,正苓里,1471,614,857,12,1483,3906,37.97,15.72
高雄市,小港區,順苓里,1727,669,1058,4,1731,4344,39.85,15.4
高雄市,小港區,六苓里,1086,400,686,6,1092,2502,43.65,15.99
高雄市,小港區,宏亮里,1209,455,754,9,1218,3165,38.48,14.38
高雄市,小港區,山東里,1143,529,614,5,1148,2869,40.01,18.44
高雄市,小港區,青島里,1008,601,407,7,1015,2305,44.03,26.07
高雄市,小港區,濟南里,1662,778,884,14,1676,4066,41.22,19.13
高雄市,小港區,泰山里,1335,482,853,9,1344,3176,42.32,15.18
高雄市,小港區,山明里,4223,1446,2777,36,4259,11217,37.97,12.89
高雄市,小港區,高松里,1597,557,1040,8,1605,4154,38.64,13.41
高雄市,小港區,松金里,1003,354,649,9,1012,2549,39.7,13.89
高雄市,小港區,松山里,1327,518,809,15,1342,3066,43.77,16.89
高雄市,小港區,大坪里,1113,362,751,15,1128,2844,39.66,12.73
高雄市,小港區,坪頂里,2184,737,1447,14,2198,6006,36.6,12.27
高雄市,小港區,孔宅里,1932,718,1214,16,1948,4655,41.85,15.42
高雄市,小港區,廈莊里,1478,567,911,18,1496,3839,38.97,14.77
高雄市,小港區,合作里,1143,377,766,8,1151,2569,44.8,14.67
高雄市,小港區,桂林里,3077,1089,1988,18,3095,7687,40.26,14.17
高雄市,小港區,中厝里,1361,490,871,10,1371,3630,37.77,13.5
高雄市,小港區,鳳鳴里,1215,408,807,14,1229,3132,39.24,13.03
高雄市,小港區,龍鳳里,1188,385,803,9,1197,3059,39.13,12.59
高雄市,小港區,鳳森里,888,223,665,16,904,2196,41.17,10.15
高雄市,小港區,鳳林里,1204,321,883,10,1214,3013,40.29,10.65
高雄市,小港區,鳳興里,928,261,667,7,935,2483,37.66,10.51
高雄市,小港區,鳳源里,1342,301,1041,12,1354,3605,37.56,8.35
高雄市,鳳山區,縣口里,174,71,103,2,176,406,43.35,17.49
高雄市,鳳山區,成功里,275,99,176,6,281,599,46.91,16.53
高雄市,鳳山區,光明里,569,246,323,9,578,1288,44.88,19.1
高雄市,鳳山區,興中里,429,212,217,1,430,847,50.77,25.03
高雄市,鳳山區,南興里,415,161,254,0,415,864,48.03,18.63
高雄市,鳳山區,和德里,964,437,527,6,970,2199,44.11,19.87
高雄市,鳳山區,鳳崗里,491,229,262,3,494,1023,48.29,22.39
高雄市,鳳山區,中和里,1589,800,789,11,1600,3304,48.43,24.21
高雄市,鳳山區,鎮北里,3715,1471,2244,29,3744,10134,36.94,14.52
高雄市,鳳山區,縣衙里,360,175,185,1,361,800,45.13,21.88
高雄市,鳳山區,文英里,1514,598,916,10,1524,3583,42.53,16.69
高雄市,鳳山區,鎮西里,2155,898,1257,18,2173,4831,44.98,18.59
高雄市,鳳山區,鎮東里,956,399,557,3,959,2419,39.64,16.49
高雄市,鳳山區,埤頂里,2508,1206,1302,16,2524,5862,43.06,20.57
高雄市,鳳山區,中正里,1872,1511,361,20,1892,4101,46.14,36.84
高雄市,鳳山區,鎮南里,1969,784,1185,18,1987,4690,42.37,16.72
高雄市,鳳山區,老爺里,2793,927,1866,17,2810,6676,42.09,13.89
高雄市,鳳山區,瑞竹里,2117,993,1124,19,2136,5045,42.34,19.68
高雄市,鳳山區,忠義里,2046,962,1084,22,2068,4468,46.28,21.53
高雄市,鳳山區,誠義里,1684,858,826,13,1697,3708,45.77,23.14
高雄市,鳳山區,新興里,714,271,443,5,719,3408,21.1,7.95
高雄市,鳳山區,海光里,1253,707,546,9,1262,2855,44.2,24.76
高雄市,鳳山區,忠誠里,1494,572,922,9,1503,3386,44.39,16.89
高雄市,鳳山區,新甲里,1336,530,806,17,1353,2970,45.56,17.85
高雄市,鳳山區,武漢里,2009,765,1244,12,2021,4656,43.41,16.43
高雄市,鳳山區,正義里,2607,865,1742,23,2630,6047,43.49,14.3
高雄市,鳳山區,一甲里,1257,411,846,12,1269,3158,40.18,13.01
高雄市,鳳山區,福興里,2332,765,1567,20,2352,5638,41.72,13.57
高雄市,鳳山區,東門里,2221,1218,1003,20,2241,5295,42.32,23.0
高雄市,鳳山區,瑞興里,2009,1010,999,23,2032,4791,42.41,21.08
高雄市,鳳山區,天興里,1504,539,965,9,1513,3443,43.94,15.65
高雄市,鳳山區,新強里,2309,936,1373,11,2320,5183,44.76,18.06
高雄市,鳳山區,國泰里,1593,694,899,10,1603,3682,43.54,18.85
高雄市,鳳山區,鳳東里,2682,1173,1509,16,2698,6156,43.83,19.05
高雄市,鳳山區,新富里,1644,620,1024,10,1654,3986,41.5,15.55
高雄市,鳳山區,國光里,1481,667,814,7,1488,3202,46.47,20.83
高雄市,鳳山區,國隆里,1063,353,710,10,1073,2412,44.49,14.64
高雄市,鳳山區,文德里,3788,1840,1948,24,3812,8807,43.28,20.89
高雄市,鳳山區,過埤里,5106,2068,3038,26,5132,13720,37.41,15.07
高雄市,鳳山區,曹公里,878,403,475,5,883,1878,47.02,21.46
高雄市,鳳山區,興仁里,1517,665,852,14,1531,3300,46.39,20.15
高雄市,鳳山區,五福里,1325,491,834,8,1333,2954,45.13,16.62
高雄市,鳳山區,忠孝里,2444,1156,1288,14,2458,5599,43.9,20.65
高雄市,鳳山區,生明里,888,496,392,11,899,1995,45.06,24.86
高雄市,鳳山區,和興里,2037,889,1148,19,2056,4606,44.64,19.3
高雄市,鳳山區,協和里,1465,772,693,16,1481,3154,46.96,24.48
高雄市,鳳山區,文山里,2713,1010,1703,19,2732,6154,44.39,16.41
高雄市,鳳山區,福誠里,1960,723,1237,20,1980,4554,43.48,15.88
高雄市,鳳山區,誠德里,1005,571,434,20,1025,2537,40.4,22.51
高雄市,鳳山區,三民里,505,219,286,7,512,1040,49.23,21.06
高雄市,鳳山區,北門里,1664,663,1001,18,1682,3969,42.38,16.7
高雄市,鳳山區,富甲里,730,271,459,8,738,1831,40.31,14.8
高雄市,鳳山區,南成里,3518,1188,2330,25,3543,8197,43.22,14.49
高雄市,鳳山區,文華里,3604,1897,1707,30,3634,8181,44.42,23.19
高雄市,鳳山區,大德里,1701,581,1120,17,1718,4349,39.5,13.36
高雄市,鳳山區,武松里,1043,407,636,10,1053,2612,40.31,15.58
高雄市,鳳山區,文衡里,1684,757,927,10,1694,4036,41.97,18.76
高雄市,鳳山區,文福里,4077,1888,2189,25,4102,9452,43.4,19.97
高雄市,鳳山區,誠信里,811,519,292,8,819,2046,40.03,25.37
高雄市,鳳山區,誠智里,1068,589,479,12,1080,2686,40.21,21.93
高雄市,鳳山區,國富里,1179,572,607,7,1186,2531,46.86,22.6
高雄市,鳳山區,武慶里,1011,401,610,7,1018,2292,44.42,17.5
高雄市,鳳山區,海洋里,1672,689,983,11,1683,3737,45.04,18.44
高雄市,鳳山區,新武里,1041,352,689,12,1053,2353,44.75,14.96
高雄市,鳳山區,新樂里,1812,752,1060,9,1821,4273,42.62,17.6
高雄市,鳳山區,新泰里,1639,750,889,9,1648,4006,41.14,18.72
高雄市,鳳山區,中崙里,1062,462,600,10,1072,2454,43.68,18.83
高雄市,鳳山區,中榮里,1739,749,990,14,1753,4441,39.47,16.87
高雄市,鳳山區,中民里,1828,656,1172,20,1848,4469,41.35,14.68
高雄市,鳳山區,二甲里,1916,681,1235,16,1932,4472,43.2,15.23
高雄市,鳳山區,龍成里,1131,364,767,7,1138,2740,41.53,13.28
高雄市,鳳山區,富榮里,984,385,599,8,992,2367,41.91,16.27
高雄市,鳳山區,善美里,2064,771,1293,13,2077,5524,37.6,13.96
高雄市,鳳山區,南和里,1102,403,699,9,1111,2597,42.78,15.52
高雄市,鳳山區,福祥里,1092,328,764,7,1099,2652,41.44,12.37
高雄市,鳳山區,保安里,2639,970,1669,20,2659,6389,41.62,15.18
高雄市,林園區,東林里,1022,313,709,5,1027,2799,36.69,11.18
高雄市,林園區,林園里,1244,416,828,17,1261,3070,41.07,13.55
高雄市,林園區,溪州里,1537,470,1067,16,1553,4129,37.61,11.38
高雄市,林園區,潭頭里,1062,396,666,16,1078,2749,39.21,14.41
高雄市,林園區,中厝里,1239,480,759,15,1254,2981,42.07,16.1
高雄市,林園區,中門里,982,322,660,19,1001,2474,40.46,13.02
高雄市,林園區,頂厝里,1773,533,1240,18,1791,4546,39.4,11.72
高雄市,林園區,港埔里,751,201,550,11,762,1795,42.45,11.2
高雄市,林園區,西溪里,1302,322,980,16,1318,3401,38.75,9.47
高雄市,林園區,港嘴里,705,165,540,8,713,1671,42.67,9.87
高雄市,林園區,北汕里,527,178,349,3,530,1576,33.63,11.29
高雄市,林園區,林內里,718,317,401,5,723,1960,36.89,16.17
高雄市,林園區,王公里,1613,554,1059,16,1629,4087,39.86,13.56
高雄市,林園區,林家里,479,159,320,3,482,1274,37.83,12.48
高雄市,林園區,龔厝里,850,241,609,9,859,1939,44.3,12.43
高雄市,林園區,鳳芸里,710,164,546,12,722,1726,41.83,9.5
高雄市,林園區,中芸里,692,148,544,9,701,1767,39.67,8.38
高雄市,林園區,東汕里,318,87,231,3,321,883,36.35,9.85
高雄市,林園區,西汕里,263,58,205,1,264,729,36.21,7.96
高雄市,林園區,仁愛里,1203,348,855,9,1212,2918,41.54,11.93
高雄市,林園區,文賢里,1010,394,616,13,1023,2393,42.75,16.46
高雄市,林園區,廣應里,1339,404,935,11,1350,3366,40.11,12.0
高雄市,林園區,五福里,856,265,591,5,861,2660,32.37,9.96
高雄市,林園區,中汕里,764,151,613,13,777,2268,34.26,6.66
高雄市,大寮區,拷潭里,588,153,435,9,597,1391,42.92,11.0
高雄市,大寮區,內坑里,2105,794,1311,15,2120,5790,36.61,13.71
高雄市,大寮區,大寮里,2393,748,1645,33,2426,6676,36.34,11.2
高雄市,大寮區,上寮里,983,265,718,9,992,2414,41.09,10.98
高雄市,大寮區,三隆里,1873,616,1257,17,1890,4615,40.95,13.35
高雄市,大寮區,琉球里,1976,565,1411,12,1988,4639,42.85,12.18
高雄市,大寮區,翁園里,1751,442,1309,17,1768,3885,45.51,11.38
高雄市,大寮區,前庄里,1080,435,645,17,1097,2318,47.33,18.77
高雄市,大寮區,中庄里,4178,1462,2716,41,4219,10756,39.22,13.59
高雄市,大寮區,後庄里,3092,1246,1846,20,3112,7626,40.81,16.34
高雄市,大寮區,義仁里,750,219,531,10,760,1803,42.15,12.15
高雄市,大寮區,新厝里,594,170,424,5,599,1666,35.95,10.2
高雄市,大寮區,過溪里,992,323,669,11,1003,2472,40.57,13.07
高雄市,大寮區,潮寮里,1182,308,874,15,1197,2917,41.04,10.56
高雄市,大寮區,會結里,591,198,393,4,595,1538,38.69,12.87
高雄市,大寮區,會社里,2335,977,1358,27,2362,6229,37.92,15.68
高雄市,大寮區,山頂里,2967,1447,1520,27,2994,7455,40.16,19.41
高雄市,大寮區,忠義里,243,152,91,5,248,541,45.84,28.1
高雄市,大寮區,永芳里,2768,1013,1755,21,2789,6812,40.94,14.87
高雄市,大寮區,義和里,953,292,661,14,967,2201,43.93,13.27
高雄市,大寮區,溪寮里,675,221,454,7,682,1545,44.14,14.3
高雄市,大寮區,江山里,811,249,562,10,821,1851,44.35,13.45
高雄市,大寮區,昭明里,1398,399,999,14,1412,3723,37.93,10.72
高雄市,大寮區,光武里,42,28,14,4,46,111,41.44,25.23
高雄市,大寮區,中興里,2755,1650,1105,36,2791,6664,41.88,24.76
高雄市,大樹區,竹寮里,1121,419,702,5,1126,2680,42.01,15.63
高雄市,大樹區,九曲里,1908,755,1153,18,1926,5186,37.14,14.56
高雄市,大樹區,久堂里,1731,691,1040,22,1753,4079,42.98,16.94
高雄市,大樹區,水安里,1021,326,695,15,1036,2313,44.79,14.09
高雄市,大樹區,水寮里,1015,283,732,7,1022,2219,46.06,12.75
高雄市,大樹區,檨腳里,1348,417,931,9,1357,3451,39.32,12.08
高雄市,大樹區,興山里,418,88,330,3,421,1026,41.03,8.58
高雄市,大樹區,和山里,403,113,290,3,406,994,40.85,11.37
高雄市,大樹區,姑山里,437,104,333,3,440,962,45.74,10.81
高雄市,大樹區,大坑里,563,172,391,8,571,1434,39.82,11.99
高雄市,大樹區,井腳里,652,148,504,5,657,1505,43.65,9.83
高雄市,大樹區,小坪里,564,172,392,10,574,1311,43.78,13.12
高雄市,大樹區,龍目里,764,131,633,11,775,1752,44.24,7.48
高雄市,大樹區,大樹里,995,246,749,15,1010,2492,40.53,9.87
高雄市,大樹區,三和里,379,150,229,1,380,994,38.23,15.09
高雄市,大樹區,溪埔里,626,171,455,6,632,1539,41.07,11.11
高雄市,大樹區,興田里,750,312,438,9,759,1855,40.92,16.82
高雄市,大樹區,統嶺里,264,86,178,2,266,670,39.7,12.84
高雄市,大社區,嘉誠里,319,121,198,2,321,899,35.71,13.46
高雄市,大社區,保社里,1410,494,916,20,1430,3267,43.77,15.12
高雄市,大社區,大社里,2045,714,1331,17,2062,4936,41.77,14.47
高雄市,大社區,翠屏里,694,195,499,5,699,1648,42.42,11.83
高雄市,大社區,三奶里,1173,370,803,15,1188,2706,43.9,13.67
高雄市,大社區,觀音里,2410,756,1654,27,2437,5416,45.0,13.96
高雄市,大社區,神農里,1910,667,1243,19,1929,4948,38.99,13.48
高雄市,大社區,中里里,1333,438,895,15,1348,3171,42.51,13.81
高雄市,大社區,保安里,1308,410,898,21,1329,3118,42.62,13.15
高雄市,仁武區,大灣里,1835,647,1188,10,1845,4416,41.78,14.65
高雄市,仁武區,灣內里,3149,1135,2014,23,3172,7950,39.9,14.28
高雄市,仁武區,考潭里,1216,466,750,8,1224,2625,46.63,17.75
高雄市,仁武區,烏林里,1368,491,877,13,1381,3764,36.69,13.04
高雄市,仁武區,仁福里,324,108,216,8,332,849,39.1,12.72
高雄市,仁武區,仁武里,2035,654,1381,20,2055,5452,37.69,12.0
高雄市,仁武區,文武里,3767,1303,2464,26,3793,9055,41.89,14.39
高雄市,仁武區,竹後里,1012,214,798,13,1025,2172,47.19,9.85
高雄市,仁武區,八卦里,7045,2777,4268,47,7092,17709,40.05,15.68
高雄市,仁武區,高楠里,1087,395,692,14,1101,2610,42.18,15.13
高雄市,仁武區,後安里,1065,275,790,8,1073,2542,42.21,10.82
高雄市,仁武區,中華里,646,257,389,4,650,1606,40.47,16.0
高雄市,仁武區,五和里,1999,736,1263,11,2010,5171,38.87,14.23
高雄市,仁武區,仁和里,1695,651,1044,17,1712,3838,44.61,16.96
高雄市,仁武區,赤山里,2856,1098,1758,16,2872,6762,42.47,16.24
高雄市,仁武區,仁慈里,1062,412,650,11,1073,2202,48.73,18.71
高雄市,鳥松區,鳥松里,4428,1742,2686,30,4458,10418,42.79,16.72
高雄市,鳥松區,夢裡里,2314,955,1359,9,2323,4917,47.24,19.42
高雄市,鳥松區,大華里,4813,2084,2729,25,4838,9866,49.04,21.12
高雄市,鳥松區,坔埔里,1632,542,1090,11,1643,3551,46.27,15.26
高雄市,鳥松區,仁美里,2752,843,1909,21,2773,6496,42.69,12.98
高雄市,鳥松區,大竹里,335,99,236,2,337,678,49.71,14.6
高雄市,鳥松區,華美里,1730,625,1105,13,1743,3874,44.99,16.13
高雄市,岡山區,平安里,473,197,276,3,476,1073,44.36,18.36
高雄市,岡山區,岡山里,1670,652,1018,12,1682,4363,38.55,14.94
高雄市,岡山區,壽天里,1436,643,793,12,1448,3149,45.98,20.42
高雄市,岡山區,維仁里,416,152,264,4,420,985,42.64,15.43
高雄市,岡山區,後紅里,1694,816,878,16,1710,4134,41.36,19.74
高雄市,岡山區,大遼里,635,162,473,9,644,1366,47.14,11.86
高雄市,岡山區,忠孝里,1317,1019,298,20,1337,2810,47.58,36.26
高雄市,岡山區,和平里,152,66,86,2,154,300,51.33,22.0
高雄市,岡山區,前峰里,1182,458,724,16,1198,2809,42.65,16.3
高雄市,岡山區,劉厝里,709,212,497,5,714,1401,50.96,15.13
高雄市,岡山區,協和里,1614,686,928,21,1635,3572,45.77,19.2
高雄市,岡山區,後協里,2226,1041,1185,20,2246,5458,41.15,19.07
高雄市,岡山區,信義里,659,367,292,2,661,1556,42.48,23.59
高雄市,岡山區,潭底里,335,86,249,5,340,761,44.68,11.3
高雄市,岡山區,三和里,365,79,286,4,369,867,42.56,9.11
高雄市,岡山區,仁壽里,1503,618,885,11,1514,3290,46.02,18.78
高雄市,岡山區,碧紅里,1543,626,917,10,1553,3822,40.63,16.38
高雄市,岡山區,程香里,1710,749,961,20,1730,4091,42.29,18.31
高雄市,岡山區,竹圍里,2659,1043,1616,13,2672,6810,39.24,15.32
高雄市,岡山區,台上里,2313,855,1458,12,2325,5811,40.01,14.71
高雄市,岡山區,灣裡里,769,278,491,4,773,1862,41.51,14.93
高雄市,岡山區,白米里,781,305,476,7,788,1933,40.77,15.78
高雄市,岡山區,石潭里,885,317,568,7,892,1850,48.22,17.14
高雄市,岡山區,福興里,473,183,290,2,475,1048,45.32,17.46
高雄市,岡山區,本洲里,675,224,451,7,682,1683,40.52,13.31
高雄市,岡山區,嘉興里,1394,371,1023,14,1408,3339,42.17,11.11
高雄市,岡山區,嘉峰里,771,266,505,14,785,1747,44.93,15.23
高雄市,岡山區,華崗里,747,141,606,9,756,1567,48.25,9.0
高雄市,岡山區,大莊里,364,133,231,2,366,984,37.2,13.52
高雄市,岡山區,協榮里,867,446,421,3,870,2090,41.63,21.34
高雄市,岡山區,為隨里,291,92,199,2,293,631,46.43,14.58
高雄市,岡山區,壽峰里,965,430,535,7,972,2230,43.59,19.28
高雄市,岡山區,仁義里,984,866,118,11,995,1809,55.0,47.87
高雄市,橋頭區,橋頭里,942,345,597,9,951,2052,46.35,16.81
高雄市,橋頭區,橋南里,541,167,374,5,546,1060,51.51,15.75
高雄市,橋頭區,仕隆里,1132,358,774,7,1139,2289,49.76,15.64
高雄市,橋頭區,仕豐里,1249,446,803,13,1262,2597,48.59,17.17
高雄市,橋頭區,芋寮里,557,169,388,5,562,1196,46.99,14.13
高雄市,橋頭區,東林里,1074,286,788,12,1086,2294,47.34,12.47
高雄市,橋頭區,西林里,650,163,487,5,655,1371,47.78,11.89
高雄市,橋頭區,白樹里,1437,492,945,16,1453,3241,44.83,15.18
高雄市,橋頭區,筆秀里,729,203,526,5,734,1506,48.74,13.48
高雄市,橋頭區,新莊里,1859,707,1152,13,1872,4359,42.95,16.22
高雄市,橋頭區,甲北里,927,309,618,19,946,2139,44.23,14.45
高雄市,橋頭區,甲南里,1070,338,732,15,1085,2401,45.19,14.08
高雄市,橋頭區,頂鹽里,593,190,403,4,597,1340,44.55,14.18
高雄市,橋頭區,中崎里,282,52,230,3,285,662,43.05,7.85
高雄市,橋頭區,仕和里,1757,532,1225,22,1779,3625,49.08,14.68
高雄市,橋頭區,德松里,669,208,461,5,674,1442,46.74,14.42
高雄市,橋頭區,三德里,354,81,273,3,357,776,46.01,10.44
高雄市,燕巢區,尖山里,434,133,301,1,435,1096,39.69,12.14
高雄市,燕巢區,瓊林里,912,292,620,10,922,2055,44.87,14.21
高雄市,燕巢區,安招里,1384,466,918,28,1412,3308,42.68,14.09
高雄市,燕巢區,角宿里,1141,421,720,17,1158,2690,43.05,15.65
高雄市,燕巢區,鳳雄里,1049,364,685,10,1059,2471,42.86,14.73
高雄市,燕巢區,金山里,165,80,85,6,171,464,36.85,17.24
高雄市,燕巢區,東燕里,873,306,567,9,882,2315,38.1,13.22
高雄市,燕巢區,南燕里,1498,605,893,15,1513,3871,39.09,15.63
高雄市,燕巢區,西燕里,1278,451,827,12,1290,3315,38.91,13.6
高雄市,燕巢區,橫山里,703,240,463,5,708,1874,37.78,12.81
高雄市,燕巢區,深水里,885,307,578,15,900,2396,37.56,12.81
高雄市,田寮區,鹿埔里,142,52,90,0,142,347,40.92,14.99
高雄市,田寮區,南安里,363,106,257,11,374,1016,36.81,10.43
高雄市,田寮區,大同里,141,29,112,2,143,364,39.29,7.97
高雄市,田寮區,田寮里,128,34,94,1,129,364,35.44,9.34
高雄市,田寮區,七星里,224,55,169,3,227,594,38.22,9.26
高雄市,田寮區,崇德里,344,140,204,4,348,914,38.07,15.32
高雄市,田寮區,西德里,254,87,167,7,261,777,33.59,11.2
高雄市,田寮區,三和里,109,41,68,3,112,333,33.63,12.31
高雄市,田寮區,古亭里,159,41,118,3,162,484,33.47,8.47
高雄市,田寮區,新興里,449,112,337,10,459,1164,39.43,9.62
高雄市,阿蓮區,石安里,483,128,355,6,489,1283,38.11,9.98
高雄市,阿蓮區,中路里,824,181,643,11,835,1973,42.32,9.17
高雄市,阿蓮區,峯山里,461,118,343,6,467,1209,38.63,9.76
高雄市,阿蓮區,港後里,871,351,520,6,877,2122,41.33,16.54
高雄市,阿蓮區,崗山里,274,103,171,5,279,761,36.66,13.53
高雄市,阿蓮區,阿蓮里,1790,576,1214,18,1808,4888,36.99,11.78
高雄市,阿蓮區,清蓮里,952,294,658,12,964,2590,37.22,11.35
高雄市,阿蓮區,和蓮里,916,276,640,12,928,2291,40.51,12.05
高雄市,阿蓮區,青旗里,562,211,351,5,567,1541,36.79,13.69
高雄市,阿蓮區,復安里,628,220,408,12,640,1648,38.83,13.35
高雄市,阿蓮區,玉庫里,456,97,359,10,466,1043,44.68,9.3
高雄市,阿蓮區,南蓮里,1133,435,698,6,1139,2960,38.48,14.7
高雄市,路竹區,竹滬里,1151,431,720,9,1160,3254,35.65,13.25
高雄市,路竹區,頂寮里,469,165,304,6,475,1144,41.52,14.42
高雄市,路竹區,新達里,439,151,288,10,449,1195,37.57,12.64
高雄市,路竹區,後鄉里,433,150,283,4,437,1098,39.8,13.66
高雄市,路竹區,北嶺里,568,190,378,6,574,1220,47.05,15.57
高雄市,路竹區,社西里,901,326,575,8,909,2211,41.11,14.74
高雄市,路竹區,甲北里,816,286,530,10,826,2084,39.64,13.72
高雄市,路竹區,甲南里,1199,524,675,12,1211,3276,36.97,16.0
高雄市,路竹區,下坑里,965,316,649,11,976,2623,37.21,12.05
高雄市,路竹區,竹園里,650,195,455,12,662,1825,36.27,10.68
高雄市,路竹區,竹東里,1386,559,827,8,1394,3439,40.54,16.25
高雄市,路竹區,竹西里,870,345,525,6,876,2163,40.5,15.95
高雄市,路竹區,文北里,1145,391,754,12,1157,2976,38.88,13.14
高雄市,路竹區,文南里,1013,418,595,10,1023,2337,43.77,17.89
高雄市,路竹區,三爺里,356,109,247,4,360,841,42.81,12.96
高雄市,路竹區,鴨寮里,771,277,494,8,779,1908,40.83,14.52
高雄市,路竹區,社東里,678,214,464,11,689,1711,40.27,12.51
高雄市,路竹區,社中里,330,99,231,3,333,846,39.36,11.7
高雄市,路竹區,竹南里,1165,442,723,11,1176,2643,44.49,16.72
高雄市,路竹區,社南里,1813,722,1091,20,1833,4526,40.5,15.95
高雄市,湖內區,海山里,476,157,319,4,480,1070,44.86,14.67
高雄市,湖內區,劉家里,391,115,276,4,395,981,40.27,11.72
高雄市,湖內區,太爺里,357,101,256,3,360,768,46.88,13.15
高雄市,湖內區,公舘里,853,307,546,9,862,2214,38.93,13.87
高雄市,湖內區,葉厝里,1027,263,764,6,1033,2648,39.01,9.93
高雄市,湖內區,大湖里,1443,559,884,8,1451,3677,39.46,15.2
高雄市,湖內區,田尾里,397,148,249,6,403,997,40.42,14.84
高雄市,湖內區,湖內里,1471,564,907,16,1487,3781,39.33,14.92
高雄市,湖內區,海埔里,717,183,534,8,725,1752,41.38,10.45
高雄市,湖內區,文賢里,483,153,330,2,485,1198,40.48,12.77
高雄市,湖內區,中賢里,767,200,567,5,772,2155,35.82,9.28
高雄市,湖內區,逸賢里,423,119,304,7,430,1133,37.95,10.5
高雄市,湖內區,忠興里,275,84,191,2,277,700,39.57,12.0
高雄市,湖內區,湖東里,932,384,548,15,947,2739,34.57,14.02
高雄市,茄萣區,福德里,422,106,316,2,424,955,44.4,11.1
高雄市,茄萣區,萬福里,333,106,227,4,337,854,39.46,12.41
高雄市,茄萣區,白雲里,685,266,419,4,689,1718,40.1,15.48
高雄市,茄萣區,嘉賜里,1450,474,976,11,1461,3784,38.61,12.53
高雄市,茄萣區,嘉安里,665,249,416,5,670,1771,37.83,14.06
高雄市,茄萣區,嘉定里,418,105,313,5,423,1100,38.45,9.55
高雄市,茄萣區,保定里,1115,328,787,6,1121,2955,37.94,11.1
高雄市,茄萣區,光定里,306,99,207,2,308,919,33.51,10.77
高雄市,茄萣區,大定里,340,118,222,4,344,1060,32.45,11.13
高雄市,茄萣區,吉定里,434,115,319,4,438,1114,39.32,10.32
高雄市,茄萣區,嘉樂里,763,266,497,6,769,2061,37.31,12.91
高雄市,茄萣區,嘉泰里,381,98,283,3,384,1067,35.99,9.18
高雄市,茄萣區,嘉福里,314,110,204,2,316,966,32.71,11.39
高雄市,茄萣區,和協里,458,139,319,3,461,1116,41.31,12.46
高雄市,茄萣區,崎漏里,1661,606,1055,23,1684,4679,35.99,12.95
高雄市,永安區,永安里,638,252,386,4,642,1558,41.21,16.17
高雄市,永安區,永華里,732,255,477,9,741,1799,41.19,14.17
高雄市,永安區,新港里,879,278,601,13,892,2291,38.93,12.13
高雄市,永安區,鹽田里,140,32,108,2,142,374,37.97,8.56
高雄市,永安區,保寧里,944,371,573,9,953,2564,37.17,14.47
高雄市,永安區,維新里,1252,417,835,14,1266,3396,37.28,12.28
高雄市,彌陀區,光和里,500,163,337,5,505,1250,40.4,13.04
高雄市,彌陀區,彌靖里,778,280,498,9,787,1846,42.63,15.17
高雄市,彌陀區,彌仁里,212,105,107,3,215,533,40.34,19.7
高雄市,彌陀區,彌壽里,343,162,181,2,345,738,46.75,21.95
高雄市,彌陀區,彌陀里,738,298,440,5,743,1710,43.45,17.43
高雄市,彌陀區,舊港里,622,229,393,7,629,1565,40.19,14.63
高雄市,彌陀區,文安里,670,229,441,11,681,1681,40.51,13.62
高雄市,彌陀區,鹽埕里,803,297,506,7,810,2007,40.36,14.8
高雄市,彌陀區,過港里,357,133,224,7,364,918,39.65,14.49
高雄市,彌陀區,海尾里,290,134,156,7,297,804,36.94,16.67
高雄市,彌陀區,漯底里,453,212,241,5,458,1134,40.39,18.69
高雄市,彌陀區,南寮里,799,298,501,11,810,2085,38.85,14.29
高雄市,梓官區,梓信里,909,259,650,7,916,2095,43.72,12.36
高雄市,梓官區,梓義里,822,263,559,8,830,2030,40.89,12.96
高雄市,梓官區,梓和里,1089,334,755,10,1099,2213,49.66,15.09
高雄市,梓官區,梓平里,658,193,465,12,670,1476,45.39,13.08
高雄市,梓官區,中崙里,560,180,380,3,563,1154,48.79,15.6
高雄市,梓官區,赤崁里,766,216,550,8,774,1791,43.22,12.06
高雄市,梓官區,禮蚵里,796,196,600,10,806,2055,39.22,9.54
高雄市,梓官區,智蚵里,1125,370,755,5,1130,2858,39.54,12.95
高雄市,梓官區,信蚵里,876,307,569,6,882,2313,38.13,13.27
高雄市,梓官區,同安里,386,123,263,3,389,970,40.1,12.68
高雄市,梓官區,大舍里,1533,472,1061,9,1542,3701,41.66,12.75
高雄市,梓官區,赤東里,909,253,656,8,917,2221,41.29,11.39
高雄市,梓官區,赤西里,339,124,215,7,346,801,43.2,15.48
高雄市,梓官區,茄苳里,903,300,603,12,915,2258,40.52,13.29
高雄市,梓官區,典寶里,1296,488,808,15,1311,2972,44.11,16.42
高雄市,旗山區,太平里,832,341,491,9,841,2165,38.85,15.75
高雄市,旗山區,大德里,918,415,503,13,931,2273,40.96,18.26
高雄市,旗山區,湄洲里,579,215,364,6,585,1578,37.07,13.62
高雄市,旗山區,圓富里,584,222,362,11,595,1802,33.02,12.32
高雄市,旗山區,中正里,454,218,236,6,460,1418,32.44,15.37
高雄市,旗山區,大林里,412,182,230,9,421,1338,31.46,13.6
高雄市,旗山區,上洲里,384,90,294,3,387,1008,38.39,8.93
高雄市,旗山區,新光里,317,115,202,9,326,759,42.95,15.15
高雄市,旗山區,南勝里,837,246,591,17,854,2092,40.82,11.76
高雄市,旗山區,中寮里,67,18,49,1,68,179,37.99,10.06
高雄市,旗山區,東平里,806,323,483,10,816,1924,42.41,16.79
高雄市,旗山區,東昌里,389,176,213,3,392,983,39.88,17.9
高雄市,旗山區,竹峰里,571,247,324,6,577,1544,37.37,16.0
高雄市,旗山區,瑞吉里,750,281,469,11,761,1999,38.07,14.06
高雄市,旗山區,永和里,1111,408,703,9,1120,3245,34.51,12.57
高雄市,旗山區,三協里,829,332,497,10,839,2216,37.86,14.98
高雄市,旗山區,鯤洲里,326,65,261,2,328,705,46.52,9.22
高雄市,旗山區,大山里,480,151,329,7,487,1254,38.84,12.04
高雄市,旗山區,中洲里,324,92,232,6,330,797,41.41,11.54
高雄市,旗山區,南洲里,522,163,359,8,530,1262,42.0,12.92
高雄市,旗山區,廣福里,223,118,105,3,226,611,36.99,19.31
高雄市,美濃區,福安里,987,446,541,7,994,2547,39.03,17.51
高雄市,美濃區,合和里,832,447,385,10,842,2321,36.28,19.26
高雄市,美濃區,祿興里,969,498,471,13,982,2552,38.48,19.51
高雄市,美濃區,中壇里,702,374,328,4,706,1978,35.69,18.91
高雄市,美濃區,德興里,537,326,211,9,546,1462,37.35,22.3
高雄市,美濃區,龍山里,690,336,354,9,699,2113,33.08,15.9
高雄市,美濃區,獅山里,955,413,542,14,969,2433,39.83,16.97
高雄市,美濃區,龍肚里,531,250,281,6,537,1382,38.86,18.09
高雄市,美濃區,廣德里,467,204,263,6,473,1299,36.41,15.7
高雄市,美濃區,興隆里,426,179,247,6,432,1158,37.31,15.46
高雄市,美濃區,中圳里,756,388,368,8,764,2066,36.98,18.78
高雄市,美濃區,東門里,427,179,248,4,431,1184,36.4,15.12
高雄市,美濃區,泰安里,611,308,303,4,615,1527,40.28,20.17
高雄市,美濃區,瀰濃里,787,360,427,9,796,2186,36.41,16.47
高雄市,美濃區,清水里,663,313,350,2,665,1720,38.66,18.2
高雄市,美濃區,吉洋里,680,299,381,11,691,1826,37.84,16.37
高雄市,美濃區,吉和里,499,260,239,3,502,1334,37.63,19.49
高雄市,美濃區,吉東里,591,215,376,7,598,1779,33.61,12.09
高雄市,美濃區,廣林里,509,220,289,13,522,1436,36.35,15.32
高雄市,六龜區,新威里,227,75,152,5,232,714,32.49,10.5
高雄市,六龜區,新興里,191,63,128,4,195,649,30.05,9.71
高雄市,六龜區,新寮里,237,80,157,5,242,626,38.66,12.78
高雄市,六龜區,新發里,224,78,146,2,226,926,24.41,8.42
高雄市,六龜區,荖濃里,331,112,219,3,334,1359,24.58,8.24
高雄市,六龜區,六龜里,238,83,155,4,242,942,25.69,8.81
高雄市,六龜區,義寶里,352,158,194,3,355,1029,34.5,15.35
高雄市,六龜區,興龍里,221,65,156,6,227,785,28.92,8.28
高雄市,六龜區,中興里,458,251,207,11,469,1363,34.41,18.42
高雄市,六龜區,寶來里,240,93,147,7,247,858,28.79,10.84
高雄市,六龜區,文武里,368,147,221,8,376,1379,27.27,10.66
高雄市,六龜區,大津里,124,42,82,2,126,303,41.58,13.86
高雄市,甲仙區,東安里,109,57,52,3,112,445,25.17,12.81
高雄市,甲仙區,西安里,353,227,126,3,356,835,42.63,27.19
高雄市,甲仙區,和安里,230,142,88,4,234,668,35.03,21.26
高雄市,甲仙區,大田里,444,217,227,4,448,1557,28.77,13.94
高雄市,甲仙區,寶隆里,222,64,158,2,224,651,34.41,9.83
高雄市,甲仙區,關山里,199,84,115,5,204,587,34.75,14.31
高雄市,甲仙區,小林里,130,60,70,2,132,514,25.68,11.67
高雄市,杉林區,杉林里,167,52,115,2,169,597,28.31,8.71
高雄市,杉林區,木梓里,155,50,105,3,158,655,24.12,7.63
高雄市,杉林區,集來里,325,106,219,4,329,1230,26.75,8.62
高雄市,杉林區,新庄里,478,221,257,11,489,1464,33.4,15.1
高雄市,杉林區,上平里,461,225,236,11,472,1537,30.71,14.64
高雄市,杉林區,月眉里,549,270,279,9,558,1603,34.81,16.84
高雄市,杉林區,月美里,383,149,234,9,392,1207,32.48,12.34
高雄市,杉林區,大愛里,519,214,305,4,523,1965,26.62,10.89
高雄市,內門區,溝坪里,247,95,152,2,249,931,26.75,10.2
高雄市,內門區,金竹里,204,66,138,5,209,627,33.33,10.53
高雄市,內門區,永富里,287,115,172,5,292,955,30.58,12.04
高雄市,內門區,永吉里,119,57,62,1,120,413,29.06,13.8
高雄市,內門區,永興里,120,44,76,1,121,384,31.51,11.46
高雄市,內門區,石坑里,117,44,73,1,118,493,23.94,8.92
高雄市,內門區,內門里,363,161,202,5,368,963,38.21,16.72
高雄市,內門區,內豊里,364,136,228,5,369,1176,31.38,11.56
高雄市,內門區,觀亭里,558,253,305,9,567,1682,33.71,15.04
高雄市,內門區,中埔里,174,98,76,3,177,537,32.96,18.25
高雄市,內門區,內東里,280,97,183,5,285,765,37.25,12.68
高雄市,內門區,內南里,102,44,58,1,103,403,25.56,10.92
高雄市,內門區,東埔里,150,49,101,2,152,474,32.07,10.34
高雄市,內門區,三平里,195,69,126,6,201,638,31.5,10.82
高雄市,內門區,木柵里,186,52,134,2,188,589,31.92,8.83
高雄市,內門區,內興里,163,27,136,5,168,602,27.91,4.49
高雄市,內門區,瑞山里,119,60,59,3,122,318,38.36,18.87
高雄市,內門區,光興里,192,80,112,2,194,645,30.08,12.4
高雄市,茂林區,茂林里,226,181,45,0,226,712,31.74,25.42
高雄市,茂林區,萬山里,134,98,36,2,136,356,38.2,27.53
高雄市,茂林區,多納里,146,125,21,4,150,491,30.55,25.46
高雄市,桃源區,桃源里,141,115,26,5,146,766,19.06,15.01
高雄市,桃源區,寶山里,101,82,19,4,105,458,22.93,17.9
高雄市,桃源區,建山里,99,78,21,1,100,587,17.04,13.29
高雄市,桃源區,高中里,133,101,32,0,133,620,21.45,16.29
高雄市,桃源區,勤和里,45,28,17,1,46,212,21.7,13.21
高雄市,桃源區,復興里,61,58,3,1,62,287,21.6,20.21
高雄市,桃源區,拉芙蘭里,70,40,30,2,72,230,31.3,17.39
高雄市,桃源區,梅山里,70,53,17,2,72,255,28.24,20.78
高雄市,那瑪夏區,達卡努瓦里,336,273,63,3,339,1343,25.24,20.33
高雄市,那瑪夏區,瑪雅里,202,174,28,0,202,602,33.55,28.9
高雄市,那瑪夏區,南沙魯里,153,68,85,0,153,482,31.74,14.11
新竹縣,竹北市,斗崙里,2991,1689,1302,22,3013,6791,44.37,24.87
新竹縣,竹北市,鹿場里,4846,2680,2166,38,4884,10611,46.03,25.26
新竹縣,竹北市,東平里,5437,2759,2678,40,5477,11738,46.66,23.5
新竹縣,竹北市,中興里,3788,2064,1724,38,3826,8015,47.74,25.75
新竹縣,竹北市,隘口里,1310,721,589,10,1320,2974,44.38,24.24
新竹縣,竹北市,東海里,1097,747,350,14,1111,2997,37.07,24.92
新竹縣,竹北市,竹北里,2902,1741,1161,13,2915,7661,38.05,22.73
新竹縣,竹北市,竹仁里,3512,2220,1292,45,3557,8745,40.67,25.39
新竹縣,竹北市,竹義里,2075,1240,835,19,2094,5860,35.73,21.16
新竹縣,竹北市,泰和里,2234,1396,838,19,2253,5932,37.98,23.53
新竹縣,竹北市,新社里,2684,1622,1062,29,2713,7074,38.35,22.93
新竹縣,竹北市,聯興里,1770,1036,734,23,1793,4441,40.37,23.33
新竹縣,竹北市,麻園里,751,384,367,6,757,1986,38.12,19.34
新竹縣,竹北市,溪州里,1037,525,512,9,1046,2468,42.38,21.27
新竹縣,竹北市,白地里,795,412,383,18,813,2202,36.92,18.71
新竹縣,竹北市,新港里,495,183,312,8,503,1218,41.3,15.02
新竹縣,竹北市,大義里,639,251,388,5,644,1607,40.07,15.62
新竹縣,竹北市,崇義里,750,271,479,6,756,1914,39.5,14.16
新竹縣,竹北市,大眉里,691,372,319,9,700,1741,40.21,21.37
新竹縣,竹北市,尚義里,619,250,369,10,629,1683,37.37,14.85
新竹縣,竹北市,十興里,3049,1663,1386,23,3072,6632,46.32,25.08
新竹縣,竹北市,新國里,2308,1277,1031,23,2331,6000,38.85,21.28
新竹縣,竹北市,新庄里,398,226,172,6,404,1064,37.97,21.24
新竹縣,竹北市,北崙里,1651,1029,622,14,1665,3833,43.44,26.85
新竹縣,竹北市,新崙里,2518,1467,1051,29,2547,6255,40.72,23.45
新竹縣,竹北市,福德里,1353,844,509,5,1358,3262,41.63,25.87
新竹縣,竹北市,東興里,2847,1441,1406,25,2872,7126,40.3,20.22
新竹縣,竹北市,北興里,2179,1123,1056,22,2201,5571,39.51,20.16
新竹縣,竹北市,興安里,1472,911,561,14,1486,3538,42.0,25.75
新竹縣,竹北市,文化里,1500,903,597,14,1514,3337,45.37,27.06
新竹縣,竹北市,中崙里,2826,1676,1150,13,2839,6155,46.13,27.23
新竹縣,竹東鎮,上坪里,99,72,27,1,100,303,33.0,23.76
新竹縣,竹東鎮,瑞峰里,136,84,52,1,137,402,34.08,20.9
新竹縣,竹東鎮,軟橋里,133,92,41,1,134,369,36.31,24.93
新竹縣,竹東鎮,員崠里,833,607,226,6,839,2251,37.27,26.97
新竹縣,竹東鎮,東寧里,1254,893,361,10,1264,3227,39.17,27.67
新竹縣,竹東鎮,上舘里,3266,2374,892,36,3302,9255,35.68,25.65
新竹縣,竹東鎮,大鄉里,1601,1123,478,18,1619,4597,35.22,24.43
新竹縣,竹東鎮,東華里,311,204,107,0,311,643,48.37,31.73
新竹縣,竹東鎮,商華里,986,717,269,8,994,3051,32.58,23.5
新竹縣,竹東鎮,竹東里,578,348,230,10,588,1321,44.51,26.34
新竹縣,竹東鎮,榮樂里,595,412,183,3,598,1352,44.23,30.47
新竹縣,竹東鎮,鷄林里,1367,953,414,7,1374,3726,36.88,25.58
新竹縣,竹東鎮,仁愛里,1271,851,420,11,1282,3284,39.04,25.91
新竹縣,竹東鎮,五豐里,2409,1650,759,24,2433,7516,32.37,21.95
新竹縣,竹東鎮,三重里,2368,1571,797,24,2392,6371,37.55,24.66
新竹縣,竹東鎮,頭重里,1890,1195,695,21,1911,4492,42.54,26.6
新竹縣,竹東鎮,員山里,776,488,288,6,782,1905,41.05,25.62
新竹縣,竹東鎮,柯湖里,232,139,93,3,235,585,40.17,23.76
新竹縣,竹東鎮,二重里,4406,2733,1673,39,4445,11579,38.39,23.6
新竹縣,竹東鎮,中山里,642,474,168,9,651,1672,38.94,28.35
新竹縣,竹東鎮,中正里,832,553,279,15,847,2198,38.54,25.16
新竹縣,竹東鎮,南華里,434,306,128,2,436,1002,43.51,30.54
新竹縣,竹東鎮,榮華里,2716,1916,800,29,2745,6974,39.36,27.47
新竹縣,竹東鎮,忠孝里,560,384,176,6,566,1533,36.92,25.05
新竹縣,竹東鎮,陸豐里,245,168,77,3,248,579,42.83,29.02
新竹縣,新埔鎮,內立里,408,228,180,9,417,1106,37.7,20.61
新竹縣,新埔鎮,寶石里,368,231,137,5,373,857,43.52,26.95
新竹縣,新埔鎮,文山里,1815,1141,674,14,1829,4469,40.93,25.53
新竹縣,新埔鎮,五埔里,725,458,267,6,731,1976,36.99,23.18
新竹縣,新埔鎮,四座里,1383,780,603,10,1393,3266,42.65,23.88
新竹縣,新埔鎮,旱坑里,682,408,274,7,689,1753,39.3,23.27
新竹縣,新埔鎮,田新里,1255,803,452,12,1267,3147,40.26,25.52
新竹縣,新埔鎮,新埔里,403,253,150,4,407,964,42.22,26.24
新竹縣,新埔鎮,新生里,250,140,110,3,253,558,45.34,25.09
新竹縣,新埔鎮,新民里,454,317,137,3,457,1011,45.2,31.36
新竹縣,新埔鎮,上寮里,698,422,276,17,715,1823,39.22,23.15
新竹縣,新埔鎮,下寮里,1050,624,426,13,1063,2507,42.4,24.89
新竹縣,新埔鎮,南平里,432,244,188,4,436,977,44.63,24.97
新竹縣,新埔鎮,北平里,255,141,114,5,260,642,40.5,21.96
新竹縣,新埔鎮,巨埔里,489,242,247,8,497,1082,45.93,22.37
新竹縣,新埔鎮,照門里,476,269,207,10,486,1332,36.49,20.2
新竹縣,新埔鎮,清水里,188,95,93,2,190,403,47.15,23.57
新竹縣,新埔鎮,鹿鳴里,278,126,152,2,280,701,39.94,17.97
新竹縣,新埔鎮,新北里,238,137,101,6,244,570,42.81,24.04
新竹縣,關西鎮,東興里,223,167,56,1,224,472,47.46,35.38
新竹縣,關西鎮,西安里,766,538,228,5,771,1896,40.66,28.38
新竹縣,關西鎮,南雄里,290,194,96,4,294,677,43.43,28.66
新竹縣,關西鎮,北斗里,1443,950,493,21,1464,3579,40.91,26.54
新竹縣,關西鎮,仁安里,398,240,158,9,407,960,42.4,25.0
新竹縣,關西鎮,北山里,320,186,134,4,324,756,42.86,24.6
新竹縣,關西鎮,南山里,346,199,147,13,359,1025,35.02,19.41
新竹縣,關西鎮,東安里,1310,856,454,11,1321,3726,35.45,22.97
新竹縣,關西鎮,東光里,447,282,165,6,453,1248,36.3,22.6
新竹縣,關西鎮,新富里,167,94,73,6,173,529,32.7,17.77
新竹縣,關西鎮,金山里,207,135,72,2,209,549,38.07,24.59
新竹縣,關西鎮,錦山里,285,193,92,3,288,904,31.86,21.35
新竹縣,關西鎮,玉山里,129,67,62,3,132,431,30.63,15.55
新竹縣,關西鎮,大同里,347,169,178,3,350,787,44.47,21.47
新竹縣,關西鎮,石光里,656,413,243,6,662,1735,38.16,23.8
新竹縣,關西鎮,上林里,325,215,110,6,331,798,41.48,26.94
新竹縣,關西鎮,新力里,214,153,61,3,217,537,40.41,28.49
新竹縣,關西鎮,南和里,308,184,124,12,320,799,40.05,23.03
新竹縣,關西鎮,東山里,324,191,133,6,330,824,40.05,23.18
新竹縣,關西鎮,南新里,315,211,104,4,319,889,35.88,23.73
新竹縣,關西鎮,東平里,410,252,158,3,413,926,44.6,27.21
新竹縣,湖口鄉,孝勢村,516,350,166,7,523,1181,44.28,29.64
新竹縣,湖口鄉,仁勢村,378,241,137,4,382,855,44.68,28.19
新竹縣,湖口鄉,愛勢村,1557,1005,552,24,1581,3959,39.93,25.39
新竹縣,湖口鄉,信勢村,1940,1229,711,22,1962,5246,37.4,23.43
新竹縣,湖口鄉,中勢村,1245,796,449,13,1258,3221,39.06,24.71
新竹縣,湖口鄉,德盛村,1670,1053,617,15,1685,4921,34.24,21.4
新竹縣,湖口鄉,和興村,1022,589,433,6,1028,2816,36.51,20.92
新竹縣,湖口鄉,長嶺村,1115,717,398,12,1127,3163,35.63,22.67
新竹縣,湖口鄉,長安村,370,233,137,2,372,1045,35.6,22.3
新竹縣,湖口鄉,湖口村,1062,669,393,12,1074,2753,39.01,24.3
新竹縣,湖口鄉,湖鏡村,1001,731,270,16,1017,2452,41.48,29.81
新竹縣,湖口鄉,湖南村,608,416,192,4,612,1495,40.94,27.83
新竹縣,湖口鄉,波羅村,745,466,279,7,752,2217,33.92,21.02
新竹縣,湖口鄉,鳳凰村,1625,1061,564,15,1640,5086,32.25,20.86
新竹縣,湖口鄉,鳳山村,1171,844,327,11,1182,3248,36.39,25.99
新竹縣,湖口鄉,中興村,1883,1350,533,21,1904,6149,30.96,21.95
新竹縣,湖口鄉,信義村,1419,899,520,10,1429,3854,37.08,23.33
新竹縣,湖口鄉,中正村,1345,839,506,13,1358,3485,38.97,24.07
新竹縣,湖口鄉,東興村,1467,903,564,10,1477,4375,33.76,20.64
新竹縣,湖口鄉,勝利村,1362,954,408,16,1378,4199,32.82,22.72
新竹縣,新豐鄉,福興村,399,227,172,10,409,1086,37.66,20.9
新竹縣,新豐鄉,後湖村,626,337,289,10,636,1798,35.37,18.74
新竹縣,新豐鄉,青埔村,652,386,266,6,658,1867,35.24,20.67
新竹縣,新豐鄉,埔和村,1017,452,565,7,1024,2772,36.94,16.31
新竹縣,新豐鄉,瑞興村,572,347,225,7,579,1847,31.35,18.79
新竹縣,新豐鄉,坡頭村,308,126,182,5,313,833,37.58,15.13
新竹縣,新豐鄉,中崙村,1092,684,408,13,1105,3202,34.51,21.36
新竹縣,新豐鄉,重興村,1748,1101,647,30,1778,5247,33.89,20.98
新竹縣,新豐鄉,新豐村,730,339,391,3,733,2073,35.36,16.35
新竹縣,新豐鄉,員山村,987,674,313,5,992,2634,37.66,25.59
新竹縣,新豐鄉,松林村,1708,1108,600,15,1723,4372,39.41,25.34
新竹縣,新豐鄉,上坑村,570,365,205,13,583,1508,38.66,24.2
新竹縣,新豐鄉,鳳坑村,395,239,156,7,402,1044,38.51,22.89
新竹縣,新豐鄉,忠孝村,1344,870,474,12,1356,3558,38.11,24.45
新竹縣,新豐鄉,山崎村,1705,1095,610,18,1723,4427,38.92,24.73
新竹縣,新豐鄉,松柏村,2025,1269,756,13,2038,5803,35.12,21.87
新竹縣,新豐鄉,崎頂村,996,633,363,13,1009,2708,37.26,23.38
新竹縣,芎林鄉,五龍村,200,148,52,0,200,491,40.73,30.14
新竹縣,芎林鄉,華龍村,166,119,47,3,169,384,44.01,30.99
新竹縣,芎林鄉,秀湖村,364,272,92,4,368,934,39.4,29.12
新竹縣,芎林鄉,永興村,158,120,38,1,159,409,38.88,29.34
新竹縣,芎林鄉,石潭村,1015,692,323,11,1026,2655,38.64,26.06
新竹縣,芎林鄉,新鳳村,588,381,207,9,597,1577,37.86,24.16
新竹縣,芎林鄉,中坑村,238,171,67,5,243,626,38.82,27.32
新竹縣,芎林鄉,水坑村,308,189,119,6,314,779,40.31,24.26
新竹縣,芎林鄉,文林村,926,646,280,10,936,2349,39.85,27.5
新竹縣,芎林鄉,芎林村,655,403,252,10,665,1559,42.66,25.85
新竹縣,芎林鄉,上山村,1990,1248,742,16,2006,4643,43.2,26.88
新竹縣,芎林鄉,下山村,483,305,178,4,487,1098,44.35,27.78
新竹縣,橫山鄉,橫山村,1217,836,381,21,1238,3300,37.52,25.33
新竹縣,橫山鄉,田寮村,341,210,131,6,347,847,40.97,24.79
新竹縣,橫山鄉,南昌村,79,57,22,1,80,180,44.44,31.67
新竹縣,橫山鄉,豐鄉村,75,44,31,2,77,203,37.93,21.67
新竹縣,橫山鄉,豐田村,120,83,37,2,122,320,38.13,25.94
新竹縣,橫山鄉,內灣村,343,243,100,7,350,882,39.68,27.55
新竹縣,橫山鄉,福興村,162,104,58,4,166,419,39.62,24.82
新竹縣,橫山鄉,沙坑村,410,273,137,8,418,938,44.56,29.1
新竹縣,橫山鄉,新興村,621,470,151,13,634,1488,42.61,31.59
新竹縣,橫山鄉,大肚村,606,461,145,6,612,1628,37.59,28.32
新竹縣,橫山鄉,力行村,338,250,88,4,342,802,42.64,31.17
新竹縣,北埔鄉,北埔村,411,276,135,4,415,1117,37.15,24.71
新竹縣,北埔鄉,南興村,414,291,123,8,422,1142,36.95,25.48
新竹縣,北埔鄉,埔尾村,935,624,311,8,943,2547,37.02,24.5
新竹縣,北埔鄉,水磜村,278,170,108,4,282,818,34.47,20.78
新竹縣,北埔鄉,南埔村,181,133,48,0,181,363,49.86,36.64
新竹縣,北埔鄉,大林村,271,206,65,1,272,720,37.78,28.61
新竹縣,北埔鄉,大湖村,185,131,54,2,187,541,34.57,24.21
新竹縣,北埔鄉,南坑村,141,98,43,3,144,325,44.31,30.15
新竹縣,北埔鄉,外坪村,120,71,49,2,122,297,41.08,23.91
新竹縣,寶山鄉,雙溪村,1014,618,396,8,1022,2659,38.44,23.24
新竹縣,寶山鄉,大崎村,872,536,336,7,879,2006,43.82,26.72
新竹縣,寶山鄉,三峰村,397,241,156,7,404,1015,39.8,23.74
新竹縣,寶山鄉,新城村,427,254,173,3,430,1168,36.82,21.75
新竹縣,寶山鄉,深井村,326,206,120,1,327,794,41.18,25.94
新竹縣,寶山鄉,寶斗村,231,155,76,2,233,731,31.87,21.2
新竹縣,寶山鄉,山湖村,247,159,88,2,249,541,46.03,29.39
新竹縣,寶山鄉,寶山村,342,216,126,5,347,847,40.97,25.5
新竹縣,寶山鄉,油田村,251,166,85,1,252,578,43.6,28.72
新竹縣,寶山鄉,雙新村,1033,659,374,8,1041,2676,38.9,24.63
新竹縣,峨眉鄉,峨眉村,368,257,111,7,375,815,46.01,31.53
新竹縣,峨眉鄉,中盛村,267,156,111,6,273,665,41.05,23.46
新竹縣,峨眉鄉,石井村,242,158,84,0,242,563,42.98,28.06
新竹縣,峨眉鄉,富興村,493,316,177,3,496,1340,37.01,23.58
新竹縣,峨眉鄉,七星村,248,157,91,1,249,605,41.16,25.95
新竹縣,峨眉鄉,湖光村,328,193,135,5,333,850,39.18,22.71
新竹縣,尖石鄉,義興村,168,128,40,1,169,587,28.79,21.81
新竹縣,尖石鄉,嘉樂村,269,213,56,2,271,818,33.13,26.04
新竹縣,尖石鄉,新樂村,313,269,44,5,318,1210,26.28,22.23
新竹縣,尖石鄉,梅花村,202,172,30,2,204,626,32.59,27.48
新竹縣,尖石鄉,錦屏村,257,211,46,1,258,1161,22.22,18.17
新竹縣,尖石鄉,玉峰村,242,169,73,2,244,1329,18.36,12.72
新竹縣,尖石鄉,秀巒村,261,196,65,4,265,1629,16.27,12.03
新竹縣,五峰鄉,大隘村,346,304,42,4,350,1281,27.32,23.73
新竹縣,五峰鄉,花園村,205,160,45,1,206,711,28.97,22.5
新竹縣,五峰鄉,竹林村,100,79,21,0,100,377,26.53,20.95
新竹縣,五峰鄉,桃山村,359,261,98,4,363,1367,26.55,19.09
苗栗縣,苗栗市,中苗里,477,328,149,2,479,1116,42.92,29.39
苗栗縣,苗栗市,建功里,1694,1201,493,12,1706,4048,42.14,29.67
苗栗縣,苗栗市,青苗里,361,243,118,4,365,1005,36.32,24.18
苗栗縣,苗栗市,玉清里,1031,750,281,7,1038,2166,47.92,34.63
苗栗縣,苗栗市,玉華里,1530,1105,425,16,1546,3579,43.2,30.87
苗栗縣,苗栗市,維新里,1493,1083,410,18,1511,3590,42.09,30.17
苗栗縣,苗栗市,維祥里,1224,889,335,12,1236,3260,37.91,27.27
苗栗縣,苗栗市,綠苗里,321,223,98,2,323,805,40.12,27.7
苗栗縣,苗栗市,高苗里,1208,832,376,5,1213,3216,37.72,25.87
苗栗縣,苗栗市,玉苗里,360,228,132,8,368,856,42.99,26.64
苗栗縣,苗栗市,大同里,231,146,85,3,234,497,47.08,29.38
苗栗縣,苗栗市,新苗里,355,215,140,2,357,841,42.45,25.56
苗栗縣,苗栗市,勝利里,1653,1129,524,7,1660,3843,43.2,29.38
苗栗縣,苗栗市,恭敬里,500,321,179,8,508,1333,38.11,24.08
苗栗縣,苗栗市,上苗里,669,433,236,10,679,1503,45.18,28.81
苗栗縣,苗栗市,北苗里,2073,1407,666,17,2090,5025,41.59,28.0
苗栗縣,苗栗市,清華里,1387,959,428,10,1397,3087,45.25,31.07
苗栗縣,苗栗市,嘉盛里,1381,956,425,12,1393,3365,41.4,28.41
苗栗縣,苗栗市,福星里,1572,1058,514,15,1587,4152,38.22,25.48
苗栗縣,苗栗市,新川里,440,300,140,8,448,1166,38.42,25.73
苗栗縣,苗栗市,文山里,1605,1106,499,8,1613,4041,39.92,27.37
苗栗縣,苗栗市,福麗里,2048,1431,617,17,2065,5344,38.64,26.78
苗栗縣,苗栗市,水源里,940,648,292,8,948,2448,38.73,26.47
苗栗縣,苗栗市,新英里,569,375,194,7,576,1664,34.62,22.54
苗栗縣,苗栗市,福安里,1254,887,367,13,1267,3443,36.8,25.76
苗栗縣,苗栗市,嘉新里,1239,878,361,15,1254,2769,45.29,31.71
苗栗縣,苗栗市,南勢里,645,446,199,5,650,1926,33.75,23.16
苗栗縣,苗栗市,文聖里,1261,853,408,14,1275,3556,35.85,23.99
苗栗縣,苑裡鎮,苑東里,820,394,426,7,827,2145,38.55,18.37
苗栗縣,苑裡鎮,苑南里,604,260,344,1,605,1435,42.16,18.12
苗栗縣,苑裡鎮,苑北里,361,152,209,5,366,878,41.69,17.31
苗栗縣,苑裡鎮,西平里,575,225,350,3,578,1612,35.86,13.96
苗栗縣,苑裡鎮,苑港里,416,126,290,7,423,1191,35.52,10.58
苗栗縣,苑裡鎮,西勢里,710,295,415,4,714,1961,36.41,15.04
苗栗縣,苑裡鎮,海岸里,344,133,211,2,346,1037,33.37,12.83
苗栗縣,苑裡鎮,房裡里,773,336,437,4,777,2186,35.54,15.37
苗栗縣,苑裡鎮,客庄里,1519,684,835,9,1528,3952,38.66,17.31
苗栗縣,苑裡鎮,中正里,711,307,404,6,717,2128,33.69,14.43
苗栗縣,苑裡鎮,苑坑里,285,99,186,0,285,912,31.25,10.86
苗栗縣,苑裡鎮,水坡里,224,76,148,0,224,628,35.67,12.1
苗栗縣,苑裡鎮,新復里,536,250,286,5,541,1353,39.99,18.48
苗栗縣,苑裡鎮,山脚里,485,213,272,1,486,1350,36.0,15.78
苗栗縣,苑裡鎮,舊社里,623,300,323,10,633,1788,35.4,16.78
苗栗縣,苑裡鎮,福田里,426,202,224,4,430,1235,34.82,16.36
苗栗縣,苑裡鎮,石鎮里,185,94,91,2,187,546,34.25,17.22
苗栗縣,苑裡鎮,蕉埔里,276,144,132,1,277,770,35.97,18.7
苗栗縣,苑裡鎮,社苓里,770,318,452,10,780,2413,32.32,13.18
苗栗縣,苑裡鎮,泰田里,567,210,357,7,574,1649,34.81,12.73
苗栗縣,苑裡鎮,上舘里,559,260,299,11,570,1604,35.54,16.21
苗栗縣,苑裡鎮,玉田里,558,243,315,4,562,1758,31.97,13.82
苗栗縣,苑裡鎮,南勢里,224,84,140,1,225,680,33.09,12.35
苗栗縣,苑裡鎮,山柑里,437,221,216,6,443,1419,31.22,15.57
苗栗縣,苑裡鎮,田心里,661,321,340,4,665,1872,35.52,17.15
苗栗縣,通霄鎮,通東里,407,181,226,4,411,1064,38.63,17.01
苗栗縣,通霄鎮,通西里,795,374,421,3,798,1916,41.65,19.52
苗栗縣,通霄鎮,平元里,720,322,398,8,728,1805,40.33,17.84
苗栗縣,通霄鎮,梅南里,513,216,297,10,523,1531,34.16,14.11
苗栗縣,通霄鎮,圳頭里,247,110,137,3,250,676,36.98,16.27
苗栗縣,通霄鎮,通南里,877,400,477,4,881,2637,33.41,15.17
苗栗縣,通霄鎮,城北里,225,106,119,2,227,658,34.5,16.11
苗栗縣,通霄鎮,城南里,311,137,174,11,322,903,35.66,15.17
苗栗縣,通霄鎮,南和里,291,119,172,3,294,769,38.23,15.47
苗栗縣,通霄鎮,福興里,223,118,105,6,229,622,36.82,18.97
苗栗縣,通霄鎮,坪頂里,393,211,182,7,400,1189,33.64,17.75
苗栗縣,通霄鎮,五南里,440,215,225,6,446,1325,33.66,16.23
苗栗縣,通霄鎮,五北里,460,191,269,2,462,1379,33.5,13.85
苗栗縣,通霄鎮,內湖里,527,249,278,5,532,1822,29.2,13.67
苗栗縣,通霄鎮,楓樹里,145,82,63,0,145,415,34.94,19.76
苗栗縣,通霄鎮,烏眉里,294,187,107,2,296,856,34.58,21.85
苗栗縣,通霄鎮,福龍里,124,84,40,0,124,385,32.21,21.82
苗栗縣,通霄鎮,福源里,226,121,105,4,230,770,29.87,15.71
苗栗縣,通霄鎮,通灣里,629,308,321,4,633,2187,28.94,14.08
苗栗縣,通霄鎮,新埔里,338,112,226,2,340,1078,31.54,10.39
苗栗縣,通霄鎮,內島里,222,93,129,1,223,709,31.45,13.12
苗栗縣,通霄鎮,白東里,426,224,202,4,430,1405,30.6,15.94
苗栗縣,通霄鎮,白西里,230,107,123,1,231,709,32.58,15.09
苗栗縣,通霄鎮,平安里,675,307,368,10,685,2009,34.1,15.28
苗栗縣,竹南鎮,竹南里,813,474,339,2,815,1893,43.05,25.04
苗栗縣,竹南鎮,照南里,1440,772,668,14,1454,3293,44.15,23.44
苗栗縣,竹南鎮,正南里,970,490,480,5,975,2715,35.91,18.05
苗栗縣,竹南鎮,新南里,2000,1131,869,21,2021,4759,42.47,23.77
苗栗縣,竹南鎮,大厝里,2098,1270,828,25,2123,5205,40.79,24.4
苗栗縣,竹南鎮,營盤里,1325,693,632,15,1340,3484,38.46,19.89
苗栗縣,竹南鎮,聖福里,1364,785,579,11,1375,3366,40.85,23.32
苗栗縣,竹南鎮,竹興里,1047,573,474,9,1056,3259,32.4,17.58
苗栗縣,竹南鎮,龍鳳里,749,415,334,7,756,2041,37.04,20.33
苗栗縣,竹南鎮,山佳里,1657,997,660,16,1673,4916,34.03,20.28
苗栗縣,竹南鎮,中港里,403,228,175,5,408,1080,37.78,21.11
苗栗縣,竹南鎮,中華里,1157,648,509,9,1166,2759,42.26,23.49
苗栗縣,竹南鎮,中英里,537,301,236,2,539,1520,35.46,19.8
苗栗縣,竹南鎮,中美里,723,413,310,2,725,1941,37.35,21.28
苗栗縣,竹南鎮,開元里,439,229,210,3,442,1207,36.62,18.97
苗栗縣,竹南鎮,海口里,1355,758,597,7,1362,4107,33.16,18.46
苗栗縣,竹南鎮,港墘里,827,454,373,7,834,2198,37.94,20.66
苗栗縣,竹南鎮,公舘里,376,251,125,5,381,1138,33.48,22.06
苗栗縣,竹南鎮,大埔里,1555,857,698,15,1570,4771,32.91,17.96
苗栗縣,竹南鎮,頂埔里,792,410,382,18,810,2066,39.21,19.85
苗栗縣,竹南鎮,崎頂里,1399,778,621,18,1417,3817,37.12,20.38
苗栗縣,竹南鎮,公義里,365,191,174,4,369,1009,36.57,18.93
苗栗縣,竹南鎮,佳興里,1191,622,569,22,1213,3241,37.43,19.19
苗栗縣,竹南鎮,天文里,840,510,330,5,845,2154,39.23,23.68
苗栗縣,竹南鎮,龍山里,907,486,421,11,918,2327,39.45,20.89
苗栗縣,頭份市,流東里,708,490,218,9,717,2182,32.86,22.46
苗栗縣,頭份市,珊湖里,621,419,202,3,624,1710,36.49,24.5
苗栗縣,頭份市,斗煥里,1083,785,298,10,1093,2890,37.82,27.16
苗栗縣,頭份市,新華里,1414,1029,385,14,1428,3743,38.15,27.49
苗栗縣,頭份市,興隆里,1628,1102,526,14,1642,4464,36.78,24.69
苗栗縣,頭份市,上埔里,917,654,263,11,928,2565,36.18,25.5
苗栗縣,頭份市,土牛里,371,222,149,2,373,1018,36.64,21.81
苗栗縣,頭份市,頭份里,1178,793,385,13,1191,3264,36.49,24.3
苗栗縣,頭份市,忠孝里,1288,936,352,13,1301,3066,42.43,30.53
苗栗縣,頭份市,仁愛里,577,385,192,3,580,1574,36.85,24.46
苗栗縣,頭份市,信義里,335,223,112,6,341,977,34.9,22.82
苗栗縣,頭份市,和平里,490,297,193,3,493,1036,47.59,28.67
苗栗縣,頭份市,民族里,789,565,224,10,799,2007,39.81,28.15
苗栗縣,頭份市,東庄里,1535,1050,485,13,1548,4392,35.25,23.91
苗栗縣,頭份市,後庄里,1716,1065,651,16,1732,4339,39.92,24.54
苗栗縣,頭份市,山下里,1534,1031,503,17,1551,4022,38.56,25.63
苗栗縣,頭份市,蟠桃里,1183,795,388,4,1187,3306,35.9,24.05
苗栗縣,頭份市,田寮里,1411,942,469,7,1418,3987,35.57,23.63
苗栗縣,頭份市,蘆竹里,500,291,209,7,507,1289,39.33,22.58
苗栗縣,頭份市,上興里,643,410,233,11,654,2144,30.5,19.12
苗栗縣,頭份市,下興里,887,596,291,8,895,2511,35.64,23.74
苗栗縣,頭份市,尖山里,523,370,153,4,527,1295,40.69,28.57
苗栗縣,頭份市,尖下里,916,645,271,6,922,2511,36.72,25.69
苗栗縣,頭份市,廣興里,364,255,109,8,372,878,42.37,29.04
苗栗縣,頭份市,濫坑里,828,601,227,9,837,2216,37.77,27.12
苗栗縣,頭份市,民權里,859,530,329,8,867,2277,38.08,23.28
苗栗縣,頭份市,民生里,824,548,276,9,833,2362,35.27,23.2
苗栗縣,頭份市,建國里,1382,915,467,9,1391,3387,41.07,27.02
苗栗縣,頭份市,成功里,1315,935,380,16,1331,3570,37.28,26.19
苗栗縣,頭份市,自強里,782,519,263,2,784,1951,40.18,26.6
苗栗縣,頭份市,合興里,919,608,311,7,926,2514,36.83,24.18
苗栗縣,頭份市,文化里,1342,847,495,12,1354,3515,38.52,24.1
苗栗縣,頭份市,中興里,1009,683,326,7,1016,2774,36.63,24.62
苗栗縣,後龍鎮,南龍里,461,243,218,5,466,1399,33.31,17.37
苗栗縣,後龍鎮,中龍里,315,157,158,3,318,731,43.5,21.48
苗栗縣,後龍鎮,北龍里,499,244,255,5,504,1248,40.38,19.55
苗栗縣,後龍鎮,大庄里,1473,815,658,9,1482,4216,35.15,19.33
苗栗縣,後龍鎮,溪洲里,692,391,301,9,701,2258,31.05,17.32
苗栗縣,後龍鎮,豐富里,511,346,165,4,515,1219,42.25,28.38
苗栗縣,後龍鎮,校椅里,391,268,123,7,398,1026,38.79,26.12
苗栗縣,後龍鎮,埔頂里,848,465,383,13,861,2669,32.26,17.42
苗栗縣,後龍鎮,新民里,492,288,204,4,496,1304,38.04,22.09
苗栗縣,後龍鎮,復興里,240,118,122,3,243,679,35.79,17.38
苗栗縣,後龍鎮,東明里,445,218,227,4,449,1462,30.71,14.91
苗栗縣,後龍鎮,大山里,496,236,260,4,500,1503,33.27,15.7
苗栗縣,後龍鎮,灣寶里,377,179,198,11,388,1231,31.52,14.54
苗栗縣,後龍鎮,海寶里,305,136,169,6,311,957,32.5,14.21
苗栗縣,後龍鎮,外埔里,301,182,119,4,305,982,31.06,18.53
苗栗縣,後龍鎮,海埔里,269,126,143,5,274,897,30.55,14.05
苗栗縣,後龍鎮,秀水里,240,114,126,3,243,682,35.63,16.72
苗栗縣,後龍鎮,水尾里,337,166,171,6,343,1023,33.53,16.23
苗栗縣,後龍鎮,龍津里,209,111,98,4,213,591,36.04,18.78
苗栗縣,後龍鎮,龍坑里,404,172,232,9,413,1251,33.01,13.75
苗栗縣,後龍鎮,福寧里,214,110,104,2,216,718,30.08,15.32
苗栗縣,後龍鎮,中和里,307,174,133,3,310,1010,30.69,17.23
苗栗縣,後龍鎮,南港里,356,177,179,5,361,1188,30.39,14.9
苗栗縣,卓蘭鎮,中街里,317,162,155,1,318,698,45.56,23.21
苗栗縣,卓蘭鎮,新厝里,599,331,268,7,606,1479,40.97,22.38
苗栗縣,卓蘭鎮,上新里,757,355,402,4,761,1991,38.22,17.83
苗栗縣,卓蘭鎮,豐田里,350,162,188,7,357,937,38.1,17.29
苗栗縣,卓蘭鎮,西坪里,239,140,99,0,239,674,35.46,20.77
苗栗縣,卓蘭鎮,景山里,272,154,118,3,275,923,29.79,16.68
苗栗縣,卓蘭鎮,老庄里,742,372,370,8,750,1876,39.98,19.83
苗栗縣,卓蘭鎮,新榮里,423,186,237,7,430,1056,40.72,17.61
苗栗縣,卓蘭鎮,內灣里,742,365,377,2,744,2071,35.92,17.62
苗栗縣,卓蘭鎮,苗豐里,267,128,139,3,270,702,38.46,18.23
苗栗縣,卓蘭鎮,坪林里,346,191,155,3,349,1067,32.71,17.9
苗栗縣,卓蘭鎮,西坪里、坪林里,254,160,94,3,257,715,35.94,22.38
苗栗縣,大湖鄉,大湖村,634,458,176,4,638,1539,41.46,29.76
苗栗縣,大湖鄉,明湖村,256,206,50,1,257,557,46.14,36.98
苗栗縣,大湖鄉,靜湖村,593,447,146,10,603,1714,35.18,26.08
苗栗縣,大湖鄉,富興村,392,248,144,4,396,1323,29.93,18.75
苗栗縣,大湖鄉,大南村,169,130,39,6,175,529,33.08,24.57
苗栗縣,大湖鄉,大寮村,424,298,126,3,427,1155,36.97,25.8
苗栗縣,大湖鄉,南湖村,221,146,75,1,222,599,37.06,24.37
苗栗縣,大湖鄉,義和村,430,273,157,6,436,1448,30.11,18.85
苗栗縣,大湖鄉,東興村,234,160,74,3,237,739,32.07,21.65
苗栗縣,大湖鄉,武榮村,183,134,49,1,184,484,38.02,27.69
苗栗縣,大湖鄉,栗林村,281,187,94,1,282,988,28.54,18.93
苗栗縣,大湖鄉,新開村,300,175,125,3,303,993,30.51,17.62
苗栗縣,公館鄉,館中村,645,397,248,3,648,1507,43.0,26.34
苗栗縣,公館鄉,館東村,933,657,276,5,938,2286,41.03,28.74
苗栗縣,公館鄉,館南村,1258,855,403,15,1273,3412,37.31,25.06
苗栗縣,公館鄉,大坑村,349,215,134,5,354,921,38.44,23.34
苗栗縣,公館鄉,中義村,766,503,263,9,775,2259,34.31,22.27
苗栗縣,公館鄉,玉泉村,921,591,330,6,927,2296,40.37,25.74
苗栗縣,公館鄉,石墻村,522,378,144,2,524,1448,36.19,26.1
苗栗縣,公館鄉,福基村,396,282,114,1,397,995,39.9,28.34
苗栗縣,公館鄉,福星村,786,521,265,11,797,2019,39.47,25.8
苗栗縣,公館鄉,開礦村,103,77,26,3,106,280,37.86,27.5
苗栗縣,公館鄉,福德村,160,83,77,2,162,339,47.79,24.48
苗栗縣,公館鄉,五谷村,860,528,332,14,874,2213,39.49,23.86
苗栗縣,公館鄉,玉谷村,532,369,163,8,540,1453,37.16,25.4
苗栗縣,公館鄉,鶴岡村,646,455,191,4,650,1579,41.17,28.82
苗栗縣,公館鄉,鶴山村,534,363,171,6,540,1427,37.84,25.44
苗栗縣,公館鄉,仁安村,476,324,152,6,482,1270,37.95,25.51
苗栗縣,公館鄉,尖山村,536,346,190,6,542,1415,38.3,24.45
苗栗縣,公館鄉,南河村,87,72,15,2,89,213,41.78,33.8
苗栗縣,公館鄉,北河村,103,65,38,1,104,329,31.61,19.76
苗栗縣,銅鑼鄉,福興村,410,343,67,2,412,940,43.83,36.49
苗栗縣,銅鑼鄉,銅鑼村,1717,1208,509,21,1738,4334,40.1,27.87
苗栗縣,銅鑼鄉,朝陽村,680,485,195,6,686,1617,42.42,29.99
苗栗縣,銅鑼鄉,樟樹村,404,275,129,9,413,1247,33.12,22.05
苗栗縣,銅鑼鄉,九湖村,417,292,125,5,422,1142,36.95,25.57
苗栗縣,銅鑼鄉,竹森村,331,239,92,0,331,1021,32.42,23.41
苗栗縣,銅鑼鄉,中平村,1102,742,360,12,1114,3115,35.76,23.82
苗栗縣,銅鑼鄉,興隆村,189,119,70,2,191,540,35.37,22.04
苗栗縣,銅鑼鄉,盛隆村,144,97,47,1,145,411,35.28,23.6
苗栗縣,銅鑼鄉,新隆村,229,155,74,1,230,525,43.81,29.52
苗栗縣,南庄鄉,東村,416,307,109,5,421,1102,38.2,27.86
苗栗縣,南庄鄉,西村,221,154,67,4,225,609,36.95,25.29
苗栗縣,南庄鄉,南江村,366,278,88,8,374,1283,29.15,21.67
苗栗縣,南庄鄉,田美村,273,181,92,4,277,793,34.93,22.82
苗栗縣,南庄鄉,獅山村,263,183,80,5,268,793,33.8,23.08
苗栗縣,南庄鄉,南富村,466,342,124,6,472,1037,45.52,32.98
苗栗縣,南庄鄉,員林村,381,262,119,4,385,986,39.05,26.57
苗栗縣,南庄鄉,蓬萊村,229,183,46,5,234,838,27.92,21.84
苗栗縣,南庄鄉,東河村,227,192,35,5,232,912,25.44,21.05
苗栗縣,頭屋鄉,頭屋村,981,700,281,7,988,2420,40.83,28.93
苗栗縣,頭屋鄉,象山村,684,452,232,9,693,1786,38.8,25.31
苗栗縣,頭屋鄉,北坑村,244,178,66,2,246,687,35.81,25.91
苗栗縣,頭屋鄉,獅潭村,652,458,194,8,660,1635,40.37,28.01
苗栗縣,頭屋鄉,曲洞村,394,271,123,5,399,848,47.05,31.96
苗栗縣,頭屋鄉,飛鳳村,161,110,51,4,165,377,43.77,29.18
苗栗縣,頭屋鄉,明德村,427,287,140,3,430,968,44.42,29.65
苗栗縣,頭屋鄉,鳴鳳村,124,75,49,4,128,302,42.38,24.83
苗栗縣,三義鄉,廣盛村,1595,1101,494,11,1606,3909,41.08,28.17
苗栗縣,三義鄉,双湖村,690,467,223,5,695,1787,38.89,26.13
苗栗縣,三義鄉,双潭村,487,331,156,3,490,1321,37.09,25.06
苗栗縣,三義鄉,勝興村,1326,844,482,16,1342,3286,40.84,25.68
苗栗縣,三義鄉,西湖村,567,425,142,10,577,1427,40.43,29.78
苗栗縣,三義鄉,龍騰村,168,123,45,2,170,402,42.29,30.6
苗栗縣,三義鄉,鯉魚潭村,466,231,235,6,472,1241,38.03,18.61
苗栗縣,西湖鄉,高埔村,229,184,45,5,234,595,39.33,30.92
苗栗縣,西湖鄉,下埔村,193,149,44,5,198,564,35.11,26.42
苗栗縣,西湖鄉,五湖村,279,200,79,4,283,790,35.82,25.32
苗栗縣,西湖鄉,四湖村,205,160,45,2,207,627,33.01,25.52
苗栗縣,西湖鄉,金獅村,180,137,43,2,182,482,37.76,28.42
苗栗縣,西湖鄉,龍洞村,149,95,54,3,152,446,34.08,21.3
苗栗縣,西湖鄉,三湖村,315,212,103,3,318,871,36.51,24.34
苗栗縣,西湖鄉,湖東村,339,243,96,4,343,1112,30.85,21.85
苗栗縣,西湖鄉,二湖村,215,148,67,2,217,646,33.59,22.91
苗栗縣,造橋鄉,造橋村,756,523,233,6,762,2010,37.91,26.02
苗栗縣,造橋鄉,平興村,176,124,52,0,176,442,39.82,28.05
苗栗縣,造橋鄉,豐湖村,378,249,129,3,381,969,39.32,25.7
苗栗縣,造橋鄉,大西村,1202,803,399,9,1211,3315,36.53,24.22
苗栗縣,造橋鄉,錦水村,183,126,57,2,185,479,38.62,26.3
苗栗縣,造橋鄉,大龍村,190,124,66,2,192,485,39.59,25.57
苗栗縣,造橋鄉,朝陽村,435,241,194,5,440,1252,35.14,19.25
苗栗縣,造橋鄉,談文村,289,183,106,4,293,837,35.01,21.86
苗栗縣,造橋鄉,龍昇村,300,156,144,3,303,943,32.13,16.54
苗栗縣,三灣鄉,三灣村,770,524,246,5,775,2118,36.59,24.74
苗栗縣,三灣鄉,內灣村,267,195,72,6,273,613,44.54,31.81
苗栗縣,三灣鄉,銅鏡村,320,233,87,5,325,822,39.54,28.35
苗栗縣,三灣鄉,頂寮村,72,45,27,2,74,227,32.6,19.82
苗栗縣,三灣鄉,北埔村,162,105,57,4,166,517,32.11,20.31
苗栗縣,三灣鄉,大河村,201,136,65,3,204,523,39.01,26.0
苗栗縣,三灣鄉,大坪村,181,123,58,3,184,391,47.06,31.46
苗栗縣,三灣鄉,永和村,158,125,33,6,164,368,44.57,33.97
苗栗縣,獅潭鄉,百壽村,93,78,15,2,95,322,29.5,24.22
苗栗縣,獅潭鄉,永興村,203,143,60,5,208,531,39.17,26.93
苗栗縣,獅潭鄉,新店村,319,222,97,5,324,869,37.28,25.55
苗栗縣,獅潭鄉,和興村,197,134,63,3,200,539,37.11,24.86
苗栗縣,獅潭鄉,豐林村,197,148,49,8,205,548,37.41,27.01
苗栗縣,獅潭鄉,新豐村,124,89,35,2,126,323,39.01,27.55
苗栗縣,獅潭鄉,竹木村,278,203,75,3,281,650,43.23,31.23
苗栗縣,泰安鄉,八卦村,85,64,21,1,86,336,25.6,19.05
苗栗縣,泰安鄉,錦水村,315,265,50,1,316,1070,29.53,24.77
苗栗縣,泰安鄉,清安村,289,234,55,4,293,871,33.64,26.87
苗栗縣,泰安鄉,大興村,190,169,21,2,192,480,40.0,35.21
苗栗縣,泰安鄉,中興村,131,109,22,0,131,501,26.15,21.76
苗栗縣,泰安鄉,梅園村,135,111,24,2,137,481,28.48,23.08
苗栗縣,泰安鄉,象鼻村,181,152,29,2,183,666,27.48,22.82
苗栗縣,泰安鄉,士林村,196,179,17,7,203,590,34.41,30.34
彰化縣,彰化市,文化里,531,265,266,5,536,1253,42.78,21.15
彰化縣,彰化市,下廍里,2122,1060,1062,16,2138,4972,43.0,21.32
彰化縣,彰化市,興北里,680,323,357,2,682,1603,42.55,20.15
彰化縣,彰化市,信義里,376,183,193,4,380,760,50.0,24.08
彰化縣,彰化市,民生里,572,290,282,7,579,1331,43.5,21.79
彰化縣,彰化市,陽明里,746,350,396,7,753,1723,43.7,20.31
彰化縣,彰化市,萬安里,1716,835,881,17,1733,3835,45.19,21.77
彰化縣,彰化市,新興里,2257,1061,1196,24,2281,5212,43.76,20.36
彰化縣,彰化市,新華里,769,382,387,5,774,1718,45.05,22.24
彰化縣,彰化市,龍山里,832,404,428,3,835,1895,44.06,21.32
彰化縣,彰化市,中山里,345,197,148,2,347,762,45.54,25.85
彰化縣,彰化市,中正里,641,329,312,8,649,1377,47.13,23.89
彰化縣,彰化市,永福里,396,156,240,2,398,862,46.17,18.1
彰化縣,彰化市,光復里,264,96,168,2,266,642,41.43,14.95
彰化縣,彰化市,光華里,362,162,200,0,362,706,51.27,22.95
彰化縣,彰化市,萬壽里,383,139,244,1,384,864,44.44,16.09
彰化縣,彰化市,中央里,372,151,221,5,377,748,50.4,20.19
彰化縣,彰化市,富貴里,389,155,234,4,393,863,45.54,17.96
彰化縣,彰化市,民權里,465,210,255,5,470,1067,44.05,19.68
彰化縣,彰化市,西興里,1469,716,753,10,1479,3304,44.76,21.67
彰化縣,彰化市,西勢里,1553,837,716,16,1569,3585,43.77,23.35
彰化縣,彰化市,忠孝里,530,274,256,2,532,1129,47.12,24.27
彰化縣,彰化市,忠權里,1328,677,651,16,1344,3158,42.56,21.44
彰化縣,彰化市,五權里,1526,782,744,14,1540,4175,36.89,18.73
彰化縣,彰化市,長樂里,458,189,269,2,460,930,49.46,20.32
彰化縣,彰化市,東芳里,1389,647,742,14,1403,3505,40.03,18.46
彰化縣,彰化市,南安里,881,427,454,12,893,2137,41.79,19.98
彰化縣,彰化市,南美里,731,337,394,8,739,1884,39.23,17.89
彰化縣,彰化市,莿桐里,1322,626,696,13,1335,3079,43.36,20.33
彰化縣,彰化市,磚磘里,1265,617,648,11,1276,3285,38.84,18.78
彰化縣,彰化市,平和里,1680,820,860,17,1697,4235,40.07,19.36
彰化縣,彰化市,桃源里,962,484,478,6,968,2424,39.93,19.97
彰化縣,彰化市,卦山里,1088,594,494,14,1102,2437,45.22,24.37
彰化縣,彰化市,東興里,675,314,361,8,683,1511,45.2,20.78
彰化縣,彰化市,大同里,453,211,242,5,458,974,47.02,21.66
彰化縣,彰化市,永生里,545,267,278,2,547,1169,46.79,22.84
彰化縣,彰化市,華陽里,747,422,325,6,753,1770,42.54,23.84
彰化縣,彰化市,華北里,632,309,323,7,639,1426,44.81,21.67
彰化縣,彰化市,南瑶里,3240,1614,1626,15,3255,7458,43.64,21.64
彰化縣,彰化市,成功里,656,318,338,4,660,1470,44.9,21.63
彰化縣,彰化市,延和里,2082,1014,1068,21,2103,4938,42.59,20.53
彰化縣,彰化市,南興里,3132,1512,1620,21,3153,7515,41.96,20.12
彰化縣,彰化市,西安里,1218,587,631,13,1231,2775,44.36,21.15
彰化縣,彰化市,彰安里,1247,575,672,20,1267,2845,44.53,20.21
彰化縣,彰化市,光南里,640,319,321,1,641,1419,45.17,22.48
彰化縣,彰化市,介壽里,957,568,389,7,964,2598,37.11,21.86
彰化縣,彰化市,延平里,3770,1935,1835,27,3797,8962,42.37,21.59
彰化縣,彰化市,建寶里,1016,565,451,12,1028,2240,45.89,25.22
彰化縣,彰化市,福安里,449,215,234,10,459,981,46.79,21.92
彰化縣,彰化市,大竹里,1311,631,680,13,1324,3193,41.47,19.76
彰化縣,彰化市,竹中里,636,336,300,8,644,1653,38.96,20.33
彰化縣,彰化市,安溪里,783,373,410,12,795,1899,41.86,19.64
彰化縣,彰化市,香山里,1300,603,697,21,1321,3295,40.09,18.3
彰化縣,彰化市,牛埔里,1236,528,708,19,1255,2951,42.53,17.89
彰化縣,彰化市,福山里,2716,1211,1505,28,2744,6731,40.77,17.99
彰化縣,彰化市,中庄里,963,435,528,10,973,2426,40.11,17.93
彰化縣,彰化市,三村里,434,198,236,5,439,1183,37.11,16.74
彰化縣,彰化市,國聖里,1018,458,560,12,1030,2414,42.67,18.97
彰化縣,彰化市,寶廍里,477,230,247,11,488,1222,39.93,18.82
彰化縣,彰化市,茄苳里,383,189,194,5,388,936,41.45,20.19
彰化縣,彰化市,茄南里,1238,618,620,17,1255,2915,43.05,21.2
彰化縣,彰化市,阿夷里,3338,1750,1588,28,3366,8423,39.96,20.78
彰化縣,彰化市,古夷里,929,421,508,5,934,2377,39.29,17.71
彰化縣,彰化市,復興里,1775,921,854,19,1794,4046,44.34,22.76
彰化縣,彰化市,和調里,1124,570,554,8,1132,2634,42.98,21.64
彰化縣,彰化市,石牌里,418,198,220,5,423,1132,37.37,17.49
彰化縣,彰化市,福田里,468,218,250,5,473,1249,37.87,17.45
彰化縣,彰化市,竹巷里,322,134,188,2,324,840,38.57,15.95
彰化縣,彰化市,田中里,360,172,188,0,360,885,40.68,19.44
彰化縣,彰化市,快官里,458,213,245,3,461,1114,41.38,19.12
彰化縣,彰化市,台鳳里,1667,930,737,9,1676,4349,38.54,21.38
彰化縣,彰化市,崙平里,2249,1144,1105,19,2268,5297,42.82,21.6
彰化縣,彰化市,向陽里,2180,1189,991,15,2195,5234,41.94,22.72
彰化縣,鹿港鎮,大有里,465,169,296,4,469,1109,42.29,15.24
彰化縣,鹿港鎮,中興里,220,75,145,1,221,506,43.68,14.82
彰化縣,鹿港鎮,洛津里,312,122,190,3,315,847,37.19,14.4
彰化縣,鹿港鎮,順興里,377,152,225,2,379,906,41.83,16.78
彰化縣,鹿港鎮,頂厝里,2879,1217,1662,25,2904,7832,37.08,15.54
彰化縣,鹿港鎮,東崎里,1811,768,1043,20,1831,5195,35.25,14.78
彰化縣,鹿港鎮,埔崙里,1920,708,1212,27,1947,5046,38.59,14.03
彰化縣,鹿港鎮,東石里,1596,537,1059,16,1612,4391,36.71,12.23
彰化縣,鹿港鎮,郭厝里,218,75,143,0,218,521,41.84,14.4
彰化縣,鹿港鎮,新宮里,397,136,261,3,400,837,47.79,16.25
彰化縣,鹿港鎮,玉順里,448,161,287,4,452,1126,40.14,14.3
彰化縣,鹿港鎮,景福里,474,225,249,1,475,1084,43.82,20.76
彰化縣,鹿港鎮,泰興里,497,210,287,2,499,1130,44.16,18.58
彰化縣,鹿港鎮,長興里,124,62,62,0,124,267,46.44,23.22
彰化縣,鹿港鎮,龍山里,279,117,162,5,284,618,45.95,18.93
彰化縣,鹿港鎮,興化里,249,100,149,2,251,574,43.73,17.42
彰化縣,鹿港鎮,菜園里,406,118,288,7,413,877,47.09,13.45
彰化縣,鹿港鎮,街尾里,1001,388,613,7,1008,2170,46.45,17.88
彰化縣,鹿港鎮,頂番里,1328,695,633,12,1340,3879,34.54,17.92
彰化縣,鹿港鎮,頭崙里,902,438,464,14,916,2598,35.26,16.86
彰化縣,鹿港鎮,廖厝里,1323,690,633,16,1339,4105,32.62,16.81
彰化縣,鹿港鎮,溝墘里,1458,775,683,13,1471,4124,35.67,18.79
彰化縣,鹿港鎮,草中里,1164,620,544,12,1176,3189,36.88,19.44
彰化縣,鹿港鎮,頭南里,717,389,328,11,728,2191,33.23,17.75
彰化縣,鹿港鎮,山崙里,1062,460,602,6,1068,3032,35.22,15.17
彰化縣,鹿港鎮,海埔里,1182,489,693,12,1194,3575,33.4,13.68
彰化縣,鹿港鎮,詔安里,664,289,375,9,673,2076,32.42,13.92
彰化縣,鹿港鎮,洋厝里,896,379,517,20,916,2425,37.77,15.63
彰化縣,鹿港鎮,永安里,1564,665,899,21,1585,4383,36.16,15.17
彰化縣,和美鎮,竹營里,2143,1015,1128,18,2161,6113,35.35,16.6
彰化縣,和美鎮,和東里,1643,809,834,15,1658,4323,38.35,18.71
彰化縣,和美鎮,和南里,181,104,77,0,181,398,45.48,26.13
彰化縣,和美鎮,和北里,625,304,321,5,630,1796,35.08,16.93
彰化縣,和美鎮,和西里,1212,602,610,17,1229,3164,38.84,19.03
彰化縣,和美鎮,四張里,1020,480,540,6,1026,2785,36.84,17.24
彰化縣,和美鎮,頭前里,546,266,280,4,550,1672,32.89,15.91
彰化縣,和美鎮,還社里,341,184,157,2,343,847,40.5,21.72
彰化縣,和美鎮,面前里,803,389,414,7,810,2119,38.23,18.36
彰化縣,和美鎮,鎮平里,1059,514,545,11,1070,2869,37.3,17.92
彰化縣,和美鎮,大霞里,466,236,230,2,468,1464,31.97,16.12
彰化縣,和美鎮,源埤里,618,313,305,7,625,1857,33.66,16.86
彰化縣,和美鎮,南佃里,810,390,420,8,818,2204,37.11,17.7
彰化縣,和美鎮,雅溝里,458,201,257,5,463,1318,35.13,15.25
彰化縣,和美鎮,山犁里,2004,972,1032,12,2016,5228,38.56,18.59
彰化縣,和美鎮,嘉犁里,723,361,362,9,732,1959,37.37,18.43
彰化縣,和美鎮,鐵山里,1064,496,568,9,1073,2669,40.2,18.58
彰化縣,和美鎮,詔安里,762,366,396,10,772,2034,37.95,17.99
彰化縣,和美鎮,柑井里,1187,530,657,14,1201,3450,34.81,15.36
彰化縣,和美鎮,竹園里,356,144,212,8,364,868,41.94,16.59
彰化縣,和美鎮,新庄里,966,480,486,17,983,2388,41.16,20.1
彰化縣,和美鎮,犁盛里,918,400,518,10,928,2277,40.76,17.57
彰化縣,和美鎮,中寮里,363,166,197,5,368,1109,33.18,14.97
彰化縣,和美鎮,中圍里,1054,484,570,11,1065,2845,37.43,17.01
彰化縣,和美鎮,糖友里,1557,819,738,12,1569,4308,36.42,19.01
彰化縣,和美鎮,塗厝里,589,308,281,6,595,1748,34.04,17.62
彰化縣,和美鎮,地潭里,245,136,109,2,247,842,29.33,16.15
彰化縣,和美鎮,湖內里,449,175,274,3,452,1196,37.79,14.63
彰化縣,和美鎮,嘉寶里,625,286,339,7,632,2038,31.01,14.03
彰化縣,和美鎮,月眉里,1122,507,615,15,1137,3033,37.49,16.72
彰化縣,和美鎮,好修里,564,253,311,5,569,1548,36.76,16.34
彰化縣,和美鎮,仁愛里,893,438,455,6,899,2716,33.1,16.13
彰化縣,線西鄉,線西村,435,265,170,1,436,1187,36.73,22.33
彰化縣,線西鄉,頂庄村,825,490,335,14,839,2276,36.86,21.53
彰化縣,線西鄉,寓埔村,778,407,371,10,788,2324,33.91,17.51
彰化縣,線西鄉,塭仔村,441,218,223,2,443,1240,35.73,17.58
彰化縣,線西鄉,溝內村,384,195,189,2,386,1223,31.56,15.94
彰化縣,線西鄉,下犁村,680,313,367,9,689,1914,36.0,16.35
彰化縣,線西鄉,頂犁村,799,443,356,4,803,2519,31.88,17.59
彰化縣,線西鄉,德興村,506,278,228,5,511,1348,37.91,20.62
彰化縣,伸港鄉,曾家村,526,235,291,10,536,1748,30.66,13.44
彰化縣,伸港鄉,蚵寮村,417,125,292,4,421,1157,36.39,10.8
彰化縣,伸港鄉,埤墘村,481,237,244,5,486,1484,32.75,15.97
彰化縣,伸港鄉,溪底村,693,298,395,4,697,2048,34.03,14.55
彰化縣,伸港鄉,泉州村,676,372,304,5,681,1990,34.22,18.69
彰化縣,伸港鄉,泉厝村,458,216,242,3,461,1273,36.21,16.97
彰化縣,伸港鄉,海尾村,665,329,336,6,671,1826,36.75,18.02
彰化縣,伸港鄉,全興村,499,323,176,7,506,1714,29.52,18.84
彰化縣,伸港鄉,定興村,844,431,413,13,857,2652,32.32,16.25
彰化縣,伸港鄉,新港村,1717,831,886,9,1726,5173,33.37,16.06
彰化縣,伸港鄉,什股村,619,355,264,7,626,2344,26.71,15.15
彰化縣,伸港鄉,大同村,958,441,517,4,962,2622,36.69,16.82
彰化縣,伸港鄉,七嘉村,983,500,483,6,989,3002,32.94,16.66
彰化縣,伸港鄉,汴頭村,726,375,351,10,736,2240,32.86,16.74
彰化縣,福興鄉,番社村,528,156,372,4,532,1480,35.95,10.54
彰化縣,福興鄉,社尾村,490,204,286,5,495,1453,34.07,14.04
彰化縣,福興鄉,大崙村,448,201,247,7,455,1237,36.78,16.25
彰化縣,福興鄉,外埔村,505,190,315,8,513,1505,34.09,12.62
彰化縣,福興鄉,外中村,421,154,267,4,425,1168,36.39,13.18
彰化縣,福興鄉,元中村,451,201,250,4,455,1273,35.74,15.79
彰化縣,福興鄉,三汴村,530,210,320,13,543,1360,39.93,15.44
彰化縣,福興鄉,萬豐村,368,146,222,1,369,832,44.35,17.55
彰化縣,福興鄉,番婆村,725,345,380,6,731,2397,30.5,14.39
彰化縣,福興鄉,橋頭村,933,433,500,10,943,2653,35.54,16.32
彰化縣,福興鄉,秀厝村,814,350,464,9,823,2550,32.27,13.73
彰化縣,福興鄉,鎮平村,368,189,179,5,373,1172,31.83,16.13
彰化縣,福興鄉,三和村,375,110,265,12,387,1047,36.96,10.51
彰化縣,福興鄉,麥厝村,632,260,372,12,644,2180,29.54,11.93
彰化縣,福興鄉,廈粘村,586,286,300,7,593,1856,31.95,15.41
彰化縣,福興鄉,頂粘村,647,343,304,8,655,2276,28.78,15.07
彰化縣,福興鄉,福寶村,329,187,142,7,336,1276,26.33,14.66
彰化縣,福興鄉,二港村,457,187,270,4,461,1275,36.16,14.67
彰化縣,福興鄉,福興村,1293,547,746,10,1303,3643,35.77,15.02
彰化縣,福興鄉,福南村,819,380,439,10,829,2581,32.12,14.72
彰化縣,福興鄉,同安村,750,330,420,3,753,2364,31.85,13.96
彰化縣,福興鄉,西勢村,691,327,364,9,700,1917,36.52,17.06
彰化縣,秀水鄉,秀水村,685,276,409,6,691,1676,41.23,16.47
彰化縣,秀水鄉,安溪村,851,361,490,9,860,2038,42.2,17.71
彰化縣,秀水鄉,莊雅村,1041,563,478,6,1047,2642,39.63,21.31
彰化縣,秀水鄉,金興村,634,318,316,10,644,1828,35.23,17.4
彰化縣,秀水鄉,陝西村,502,277,225,6,508,1438,35.33,19.26
彰化縣,秀水鄉,安東村,1482,737,745,18,1500,3871,38.75,19.04
彰化縣,秀水鄉,鶴鳴村,1273,580,693,6,1279,3154,40.55,18.39
彰化縣,秀水鄉,馬興村,893,403,490,11,904,2279,39.67,17.68
彰化縣,秀水鄉,義興村,509,261,248,5,514,1479,34.75,17.65
彰化縣,秀水鄉,福安村,1686,805,881,11,1697,4523,37.52,17.8
彰化縣,秀水鄉,埔崙村,841,378,463,11,852,1939,43.94,19.49
彰化縣,秀水鄉,曾厝村,633,309,324,7,640,1677,38.16,18.43
彰化縣,秀水鄉,金陵村,670,271,399,3,673,1737,38.74,15.6
彰化縣,秀水鄉,下崙村,769,314,455,10,779,2170,35.9,14.47
彰化縣,花壇鄉,花壇村,1319,668,651,18,1337,3179,42.06,21.01
彰化縣,花壇鄉,金墩村,676,332,344,13,689,1758,39.19,18.89
彰化縣,花壇鄉,中庄村,919,468,451,8,927,2329,39.8,20.09
彰化縣,花壇鄉,劉厝村,456,186,270,8,464,1069,43.41,17.4
彰化縣,花壇鄉,崙雅村,559,251,308,5,564,1419,39.75,17.69
彰化縣,花壇鄉,南口村,752,394,358,11,763,1892,40.33,20.82
彰化縣,花壇鄉,中口村,294,136,158,3,297,721,41.19,18.86
彰化縣,花壇鄉,北口村,730,373,357,7,737,1803,40.88,20.69
彰化縣,花壇鄉,長沙村,1890,1018,872,18,1908,4928,38.72,20.66
彰化縣,花壇鄉,文德村,1139,566,573,8,1147,3092,37.1,18.31
彰化縣,花壇鄉,白沙村,1707,902,805,20,1727,4602,37.53,19.6
彰化縣,花壇鄉,岩竹村,517,227,290,6,523,1340,39.03,16.94
彰化縣,花壇鄉,橋頭村,1154,623,531,13,1167,3298,35.39,18.89
彰化縣,花壇鄉,灣雅村,311,179,132,1,312,890,35.06,20.11
彰化縣,花壇鄉,灣東村,334,167,167,8,342,932,36.7,17.92
彰化縣,花壇鄉,三春村,667,365,302,3,670,1906,35.15,19.15
彰化縣,花壇鄉,永春村,578,299,279,5,583,1888,30.88,15.84
彰化縣,花壇鄉,長春村,491,271,220,9,500,1605,31.15,16.88
彰化縣,芬園鄉,舊社村,587,287,300,9,596,1743,34.19,16.47
彰化縣,芬園鄉,大埔村,468,217,251,8,476,1387,34.32,15.65
彰化縣,芬園鄉,竹林村,675,343,332,9,684,1754,39.0,19.56
彰化縣,芬園鄉,社口村,859,389,470,12,871,2452,35.52,15.86
彰化縣,芬園鄉,茄荖村,893,376,517,9,902,2344,38.48,16.04
彰化縣,芬園鄉,嘉興村,652,350,302,15,667,1622,41.12,21.58
彰化縣,芬園鄉,芬園村,302,132,170,2,304,877,34.66,15.05
彰化縣,芬園鄉,縣庄村,413,158,255,4,417,1142,36.51,13.84
彰化縣,芬園鄉,圳墘村,213,93,120,10,223,647,34.47,14.37
彰化縣,芬園鄉,溪頭村,626,271,355,10,636,1646,38.64,16.46
彰化縣,芬園鄉,進芬村,348,170,178,1,349,965,36.17,17.62
彰化縣,芬園鄉,同安村,382,153,229,7,389,1139,34.15,13.43
彰化縣,芬園鄉,中崙村,256,95,161,7,263,854,30.8,11.12
彰化縣,芬園鄉,大竹村,325,116,209,4,329,966,34.06,12.01
彰化縣,芬園鄉,楓坑村,199,107,92,7,206,576,35.76,18.58
彰化縣,員林市,東和里,409,235,174,5,414,1051,39.39,22.36
彰化縣,員林市,民生里,1083,563,520,5,1088,2683,40.55,20.98
彰化縣,員林市,中正里,1303,705,598,13,1316,3068,42.89,22.98
彰化縣,員林市,仁美里,1100,572,528,7,1107,2540,43.58,22.52
彰化縣,員林市,新興里,334,149,185,5,339,695,48.78,21.44
彰化縣,員林市,和平里,1100,563,537,12,1112,2785,39.93,20.22
彰化縣,員林市,光明里,347,173,174,4,351,754,46.55,22.94
彰化縣,員林市,中山里,287,144,143,1,288,571,50.44,25.22
彰化縣,員林市,黎明里,682,340,342,7,689,1808,38.11,18.81
彰化縣,員林市,惠來里,2273,1094,1179,18,2291,5571,41.12,19.64
彰化縣,員林市,三義里,950,480,470,12,962,2460,39.11,19.51
彰化縣,員林市,新生里,1741,860,881,21,1762,4122,42.75,20.86
彰化縣,員林市,南平里,2120,1042,1078,16,2136,5313,40.2,19.61
彰化縣,員林市,南興里,1823,956,867,19,1842,4646,39.65,20.58
彰化縣,員林市,源潭里,568,234,334,10,578,1675,34.51,13.97
彰化縣,員林市,大埔里,737,363,374,14,751,2088,35.97,17.39
彰化縣,員林市,三條里,1061,521,540,9,1070,2693,39.73,19.35
彰化縣,員林市,三和里,2364,1231,1133,25,2389,6107,39.12,20.16
彰化縣,員林市,三橋里,1182,621,561,17,1199,2880,41.63,21.56
彰化縣,員林市,中央里,686,318,368,14,700,1929,36.29,16.49
彰化縣,員林市,溝皂里,1051,489,562,16,1067,2485,42.94,19.68
彰化縣,員林市,大饒里,1376,688,688,11,1387,3290,42.16,20.91
彰化縣,員林市,大明里,889,380,509,13,902,2363,38.17,16.08
彰化縣,員林市,萬年里,1517,804,713,21,1538,3631,42.36,22.14
彰化縣,員林市,崙雅里,877,482,395,7,884,2304,38.37,20.92
彰化縣,員林市,振興里,1022,557,465,5,1027,2698,38.07,20.64
彰化縣,員林市,林厝里,968,444,524,16,984,2788,35.29,15.93
彰化縣,員林市,出水里,582,221,361,7,589,1640,35.91,13.48
彰化縣,員林市,湖水里,431,164,267,4,435,1187,36.65,13.82
彰化縣,員林市,大峯里,278,171,107,3,281,713,39.41,23.98
彰化縣,員林市,鎮興里,714,347,367,6,720,1974,36.47,17.58
彰化縣,員林市,浮圳里,767,372,395,13,780,2175,35.86,17.1
彰化縣,員林市,西東里,711,288,423,12,723,1938,37.31,14.86
彰化縣,員林市,南東里,610,271,339,4,614,1738,35.33,15.59
彰化縣,員林市,中東里,604,313,291,9,613,1748,35.07,17.91
彰化縣,員林市,東北里,832,392,440,11,843,2262,37.27,17.33
彰化縣,員林市,三愛里,1240,650,590,12,1252,2953,42.4,22.01
彰化縣,員林市,三信里,987,552,435,7,994,2262,43.94,24.4
彰化縣,員林市,三多里,1109,544,565,6,1115,2449,45.53,22.21
彰化縣,員林市,仁愛里,564,285,279,2,566,1328,42.62,21.46
彰化縣,員林市,忠孝里,819,427,392,8,827,2178,37.97,19.61
彰化縣,溪湖鎮,光平里,489,227,262,4,493,1156,42.65,19.64
彰化縣,溪湖鎮,平和里,294,142,152,2,296,623,47.51,22.79
彰化縣,溪湖鎮,太平里,643,339,304,3,646,1780,36.29,19.04
彰化縣,溪湖鎮,光華里,176,104,72,2,178,420,42.38,24.76
彰化縣,溪湖鎮,東寮里,1188,641,547,11,1199,3356,35.73,19.1
彰化縣,溪湖鎮,西寮里,840,452,388,13,853,2176,39.2,20.77
彰化縣,溪湖鎮,大突里,1182,651,531,4,1186,3446,34.42,18.89
彰化縣,溪湖鎮,北勢里,449,203,246,5,454,1421,31.95,14.29
彰化縣,溪湖鎮,汴頭里,993,481,512,13,1006,3018,33.33,15.94
彰化縣,溪湖鎮,大竹里,901,477,424,14,915,2433,37.61,19.61
彰化縣,溪湖鎮,湖西里,827,433,394,6,833,2297,36.26,18.85
彰化縣,溪湖鎮,田中里,283,112,171,7,290,814,35.63,13.76
彰化縣,溪湖鎮,河東里,607,298,309,5,612,1829,33.46,16.29
彰化縣,溪湖鎮,中山里,756,403,353,8,764,2278,33.54,17.69
彰化縣,溪湖鎮,中竹里,300,137,163,0,300,817,36.72,16.77
彰化縣,溪湖鎮,東溪里,457,181,276,3,460,1353,34.0,13.38
彰化縣,溪湖鎮,西溪里,702,356,346,6,708,1836,38.56,19.39
彰化縣,溪湖鎮,湖東里,1605,797,808,12,1617,4595,35.19,17.34
彰化縣,溪湖鎮,頂庄里,204,100,104,3,207,641,32.29,15.6
彰化縣,溪湖鎮,忠覺里,474,254,220,4,478,1250,38.24,20.32
彰化縣,溪湖鎮,湳底里,237,115,122,3,240,694,34.58,16.57
彰化縣,溪湖鎮,大庭里,443,234,209,6,449,1362,32.97,17.18
彰化縣,溪湖鎮,媽厝里,385,146,239,5,390,1250,31.2,11.68
彰化縣,溪湖鎮,西勢里,706,301,405,8,714,2168,32.93,13.88
彰化縣,溪湖鎮,番婆里,569,276,293,1,570,1713,33.27,16.11
彰化縣,田中鎮,香山里,268,120,148,2,270,816,33.09,14.71
彰化縣,田中鎮,碧峰里,368,219,149,3,371,1037,35.78,21.12
彰化縣,田中鎮,東源里,277,153,124,5,282,748,37.7,20.45
彰化縣,田中鎮,復興里,532,291,241,9,541,1496,36.16,19.45
彰化縣,田中鎮,平和里,522,295,227,8,530,1448,36.6,20.37
彰化縣,田中鎮,頂潭里,462,220,242,8,470,1226,38.34,17.94
彰化縣,田中鎮,中潭里,644,289,355,4,648,1756,36.9,16.46
彰化縣,田中鎮,龍潭里,255,107,148,1,256,580,44.14,18.45
彰化縣,田中鎮,北路里,1304,705,599,13,1317,3269,40.29,21.57
彰化縣,田中鎮,西路里,932,444,488,4,936,2363,39.61,18.79
彰化縣,田中鎮,東路里,403,184,219,3,406,1041,39.0,17.68
彰化縣,田中鎮,南路里,451,193,258,3,454,1106,41.05,17.45
彰化縣,田中鎮,中路里,806,403,403,7,813,1942,41.86,20.75
彰化縣,田中鎮,新庄里,936,477,459,7,943,2399,39.31,19.88
彰化縣,田中鎮,三安里,570,204,366,6,576,1560,36.92,13.08
彰化縣,田中鎮,大崙里,441,210,231,7,448,1292,34.67,16.25
彰化縣,田中鎮,沙崙里,630,298,332,12,642,1814,35.39,16.43
彰化縣,田中鎮,新民里,1528,769,759,16,1544,4178,36.96,18.41
彰化縣,田中鎮,梅州里,433,191,242,10,443,1271,34.85,15.03
彰化縣,田中鎮,三民里,516,271,245,2,518,1561,33.18,17.36
彰化縣,田中鎮,三光里,327,146,181,2,329,913,36.04,15.99
彰化縣,田中鎮,大社里,323,133,190,8,331,866,38.22,15.36
彰化縣,大村鄉,大村村,1257,625,632,13,1270,3428,37.05,18.23
彰化縣,大村鄉,茄苳村,580,276,304,4,584,1546,37.77,17.85
彰化縣,大村鄉,南勢村,524,242,282,4,528,1493,35.37,16.21
彰化縣,大村鄉,田洋村,434,220,214,6,440,1209,36.39,18.2
彰化縣,大村鄉,新興村,384,162,222,4,388,1172,33.11,13.82
彰化縣,大村鄉,過溝村,1583,804,779,19,1602,4186,38.27,19.21
彰化縣,大村鄉,美港村,759,397,362,4,763,2092,36.47,18.98
彰化縣,大村鄉,平和村,865,421,444,9,874,2569,34.02,16.39
彰化縣,大村鄉,貢旗村,580,287,293,4,584,1569,37.22,18.29
彰化縣,大村鄉,加錫村,536,256,280,5,541,1528,35.41,16.75
彰化縣,大村鄉,村上村,545,278,267,1,546,1420,38.45,19.58
彰化縣,大村鄉,大橋村,702,365,337,5,707,2033,34.78,17.95
彰化縣,大村鄉,大崙村,556,251,305,7,563,1624,34.67,15.46
彰化縣,大村鄉,擺塘村,969,445,524,15,984,2635,37.34,16.89
彰化縣,大村鄉,黃厝村,787,367,420,8,795,2428,32.74,15.12
彰化縣,大村鄉,福興村,757,309,448,7,764,2179,35.06,14.18
彰化縣,埔鹽鄉,埔鹽村,670,405,265,8,678,1664,40.75,24.34
彰化縣,埔鹽鄉,埔南村,547,278,269,6,553,1536,36.0,18.1
彰化縣,埔鹽鄉,廍子村,457,265,192,2,459,1251,36.69,21.18
彰化縣,埔鹽鄉,出水村,335,202,133,6,341,889,38.36,22.72
彰化縣,埔鹽鄉,南港村,603,318,285,9,612,1750,34.97,18.17
彰化縣,埔鹽鄉,打廉村,330,166,164,4,334,939,35.57,17.68
彰化縣,埔鹽鄉,豐澤村,444,208,236,13,457,1306,34.99,15.93
彰化縣,埔鹽鄉,崑崙村,384,190,194,3,387,1086,35.64,17.5
彰化縣,埔鹽鄉,角樹村,272,161,111,4,276,656,42.07,24.54
彰化縣,埔鹽鄉,瓦磘村,422,213,209,4,426,1199,35.53,17.76
彰化縣,埔鹽鄉,好修村,552,307,245,6,558,1781,31.33,17.24
彰化縣,埔鹽鄉,西湖村,636,343,293,10,646,2059,31.37,16.66
彰化縣,埔鹽鄉,大有村,396,179,217,4,400,1194,33.5,14.99
彰化縣,埔鹽鄉,新興村,186,111,75,2,188,456,41.23,24.34
彰化縣,埔鹽鄉,永平村,375,202,173,4,379,1101,34.42,18.35
彰化縣,埔鹽鄉,永樂村,308,164,144,8,316,848,37.26,19.34
彰化縣,埔鹽鄉,石埤村,392,180,212,7,399,1437,27.77,12.53
彰化縣,埔鹽鄉,天盛村,253,153,100,7,260,838,31.03,18.26
彰化縣,埔鹽鄉,太平村,471,263,208,11,482,1538,31.34,17.1
彰化縣,埔鹽鄉,新水村,508,343,165,6,514,1523,33.75,22.52
彰化縣,埔鹽鄉,三省村,450,235,215,6,456,1368,33.33,17.18
彰化縣,埔鹽鄉,南新村,448,272,176,3,451,1314,34.32,20.7
彰化縣,埔心鄉,東門村,1360,634,726,11,1371,3555,38.57,17.83
彰化縣,埔心鄉,埔心村,464,199,265,3,467,1250,37.36,15.92
彰化縣,埔心鄉,義民村,611,316,295,7,618,1556,39.72,20.31
彰化縣,埔心鄉,油車村,447,239,208,8,455,1258,36.17,19.0
彰化縣,埔心鄉,瓦北村,659,276,383,2,661,1740,37.99,15.86
彰化縣,埔心鄉,瓦中村,762,345,417,9,771,1976,39.02,17.46
彰化縣,埔心鄉,瓦南村,560,227,333,5,565,1422,39.73,15.96
彰化縣,埔心鄉,太平村,654,301,353,7,661,1976,33.45,15.23
彰化縣,埔心鄉,經口村,892,373,519,7,899,2348,38.29,15.89
彰化縣,埔心鄉,大華村,227,108,119,2,229,658,34.8,16.41
彰化縣,埔心鄉,仁里村,436,205,231,7,443,1265,35.02,16.21
彰化縣,埔心鄉,舊舘村,573,247,326,4,577,1491,38.7,16.57
彰化縣,埔心鄉,南舘村,360,148,212,10,370,1065,34.74,13.9
彰化縣,埔心鄉,新舘村,339,166,173,2,341,963,35.41,17.24
彰化縣,埔心鄉,羅厝村,429,159,270,5,434,1305,33.26,12.18
彰化縣,埔心鄉,芎蕉村,662,261,401,9,671,1842,36.43,14.17
彰化縣,埔心鄉,二重村,523,223,300,8,531,1436,36.98,15.53
彰化縣,埔心鄉,梧鳳村,316,146,170,6,322,893,36.06,16.35
彰化縣,埔心鄉,埤霞村,251,124,127,1,252,736,34.24,16.85
彰化縣,埔心鄉,埤脚村,321,177,144,8,329,916,35.92,19.32
彰化縣,永靖鄉,永東村,326,178,148,3,329,761,43.23,23.39
彰化縣,永靖鄉,永西村,605,281,324,1,606,1503,40.32,18.7
彰化縣,永靖鄉,永南村,729,365,364,9,738,1800,41.0,20.28
彰化縣,永靖鄉,永北村,781,386,395,8,789,2147,36.75,17.98
彰化縣,永靖鄉,港西村,656,302,354,12,668,1704,39.2,17.72
彰化縣,永靖鄉,五福村,533,261,272,7,540,1438,37.55,18.15
彰化縣,永靖鄉,湳港村,384,127,257,4,388,1059,36.64,11.99
彰化縣,永靖鄉,新莊村,354,204,150,7,361,1065,33.9,19.15
彰化縣,永靖鄉,瑚璉村,975,483,492,14,989,2670,37.04,18.09
彰化縣,永靖鄉,五汴村,563,209,354,8,571,1368,41.74,15.28
彰化縣,永靖鄉,浮圳村,362,171,191,3,365,1220,29.92,14.02
彰化縣,永靖鄉,光雲村,555,228,327,6,561,1624,34.54,14.04
彰化縣,永靖鄉,東寧村,667,293,374,8,675,1908,35.38,15.36
彰化縣,永靖鄉,永興村,608,307,301,8,616,1558,39.54,19.7
彰化縣,永靖鄉,崙子村,515,236,279,6,521,1400,37.21,16.86
彰化縣,永靖鄉,獨鰲村,259,126,133,3,262,825,31.76,15.27
彰化縣,永靖鄉,敦厚村,244,118,126,1,245,710,34.51,16.62
彰化縣,永靖鄉,崙美村,304,118,186,5,309,736,41.98,16.03
彰化縣,永靖鄉,同安村,253,105,148,3,256,654,39.14,16.06
彰化縣,永靖鄉,同仁村,310,152,158,5,315,847,37.19,17.95
彰化縣,永靖鄉,湳墘村,292,137,155,7,299,809,36.96,16.93
彰化縣,永靖鄉,四芳村,243,135,108,3,246,637,38.62,21.19
彰化縣,永靖鄉,福興村,356,191,165,3,359,1075,33.4,17.77
彰化縣,永靖鄉,竹子村,503,172,331,7,510,1290,39.53,13.33
彰化縣,社頭鄉,社頭村,1036,418,618,8,1044,2749,37.98,15.21
彰化縣,社頭鄉,東興村,503,246,257,8,511,1460,35.0,16.85
彰化縣,社頭鄉,山湖村,425,154,271,4,429,1121,38.27,13.74
彰化縣,社頭鄉,廣興村,1573,677,896,18,1591,4439,35.84,15.25
彰化縣,社頭鄉,廣福村,342,145,197,5,347,914,37.96,15.86
彰化縣,社頭鄉,朝興村,422,187,235,7,429,1096,39.14,17.06
彰化縣,社頭鄉,仁雅村,1045,509,536,7,1052,2717,38.72,18.73
彰化縣,社頭鄉,橋頭村,756,337,419,14,770,2068,37.23,16.3
彰化縣,社頭鄉,仁和村,235,126,109,3,238,754,31.56,16.71
彰化縣,社頭鄉,崙雅村,335,160,175,4,339,905,37.46,17.68
彰化縣,社頭鄉,湳底村,565,231,334,9,574,1712,33.53,13.49
彰化縣,社頭鄉,泰安村,298,159,139,6,304,968,31.4,16.43
彰化縣,社頭鄉,美雅村,456,217,239,8,464,1252,37.06,17.33
彰化縣,社頭鄉,新厝村,545,250,295,6,551,1401,39.33,17.84
彰化縣,社頭鄉,平和村,361,165,196,1,362,961,37.67,17.17
彰化縣,社頭鄉,里仁村,373,201,172,6,379,980,38.67,20.51
彰化縣,社頭鄉,張厝村,462,213,249,8,470,1204,39.04,17.69
彰化縣,社頭鄉,龍井村,271,102,169,1,272,806,33.75,12.66
彰化縣,社頭鄉,舊社村,627,286,341,7,634,1581,40.1,18.09
彰化縣,社頭鄉,埤斗村,338,130,208,5,343,977,35.11,13.31
彰化縣,社頭鄉,湳雅村,511,203,308,5,516,1487,34.7,13.65
彰化縣,社頭鄉,松竹村,380,153,227,4,384,1028,37.35,14.88
彰化縣,社頭鄉,清水村,419,220,199,6,425,1260,33.73,17.46
彰化縣,社頭鄉,協和村,740,319,421,8,748,2148,34.82,14.85
彰化縣,二水鄉,合和村,310,138,172,1,311,821,37.88,16.81
彰化縣,二水鄉,上豊村,367,154,213,11,378,916,41.27,16.81
彰化縣,二水鄉,過圳村,239,115,124,2,241,610,39.51,18.85
彰化縣,二水鄉,五伯村,254,117,137,1,255,609,41.87,19.21
彰化縣,二水鄉,光化村,377,180,197,4,381,883,43.15,20.39
彰化縣,二水鄉,文化村,365,196,169,1,366,933,39.23,21.01
彰化縣,二水鄉,二水村,314,150,164,9,323,776,41.62,19.33
彰化縣,二水鄉,聖化村,194,126,68,6,200,438,45.66,28.77
彰化縣,二水鄉,裕民村,368,178,190,4,372,996,37.35,17.87
彰化縣,二水鄉,惠民村,333,142,191,7,340,801,42.45,17.73
彰化縣,二水鄉,大園村,262,96,166,5,267,776,34.41,12.37
彰化縣,二水鄉,修仁村,289,154,135,2,291,779,37.36,19.77
彰化縣,二水鄉,合興村,262,106,156,6,268,665,40.3,15.94
彰化縣,二水鄉,源泉村,235,117,118,4,239,597,40.03,19.6
彰化縣,二水鄉,倡和村,218,106,112,1,219,562,38.97,18.86
彰化縣,二水鄉,復興村,373,157,216,14,387,1000,38.7,15.7
彰化縣,二水鄉,十五村,268,117,151,3,271,665,40.75,17.59
彰化縣,北斗鎮,光復里,677,328,349,9,686,1771,38.74,18.52
彰化縣,北斗鎮,新政里,302,159,143,2,304,770,39.48,20.65
彰化縣,北斗鎮,重慶里,225,84,141,2,227,535,42.43,15.7
彰化縣,北斗鎮,五權里,281,128,153,1,282,656,42.99,19.51
彰化縣,北斗鎮,七星里,520,207,313,4,524,1406,37.27,14.72
彰化縣,北斗鎮,居仁里,537,321,216,3,540,1257,42.96,25.54
彰化縣,北斗鎮,東光里,827,363,464,8,835,2278,36.65,15.94
彰化縣,北斗鎮,文昌里,1120,553,567,12,1132,3114,36.35,17.76
彰化縣,北斗鎮,中和里,410,183,227,5,415,1307,31.75,14.0
彰化縣,北斗鎮,西德里,1740,831,909,18,1758,4588,38.32,18.11
彰化縣,北斗鎮,西安里,549,287,262,7,556,1694,32.82,16.94
彰化縣,北斗鎮,中寮里,949,418,531,9,958,2702,35.46,15.47
彰化縣,北斗鎮,大道里,703,291,412,5,708,1904,37.18,15.28
彰化縣,北斗鎮,新生里,591,302,289,7,598,2028,29.49,14.89
彰化縣,北斗鎮,大新里,590,313,277,7,597,1791,33.33,17.48
彰化縣,二林鎮,東和里,676,320,356,7,683,2094,32.62,15.28
彰化縣,二林鎮,南光里,1111,644,467,16,1127,3227,34.92,19.96
彰化縣,二林鎮,西平里,485,252,233,4,489,1498,32.64,16.82
彰化縣,二林鎮,北平里,952,453,499,16,968,2966,32.64,15.27
彰化縣,二林鎮,中西里,441,264,177,11,452,1610,28.07,16.4
彰化縣,二林鎮,廣興里,383,211,172,10,393,1341,29.31,15.73
彰化縣,二林鎮,香田里,299,134,165,3,302,1010,29.9,13.27
彰化縣,二林鎮,外竹里,270,144,126,5,275,976,28.18,14.75
彰化縣,二林鎮,興華里,390,233,157,7,397,1145,34.67,20.35
彰化縣,二林鎮,東興里,519,296,223,8,527,1598,32.98,18.52
彰化縣,二林鎮,後厝里,1116,647,469,20,1136,3312,34.3,19.54
彰化縣,二林鎮,豐田里,744,357,387,4,748,2497,29.96,14.3
彰化縣,二林鎮,頂厝里,362,199,163,10,372,1309,28.42,15.2
彰化縣,二林鎮,趙甲里,465,248,217,16,481,1557,30.89,15.93
彰化縣,二林鎮,振興里,331,175,156,8,339,1180,28.73,14.83
彰化縣,二林鎮,萬興里,260,142,118,5,265,770,34.42,18.44
彰化縣,二林鎮,永興里,507,253,254,2,509,1485,34.28,17.04
彰化縣,二林鎮,西庄里,353,153,200,4,357,1259,28.36,12.15
彰化縣,二林鎮,梅芳里,333,171,162,7,340,1071,31.75,15.97
彰化縣,二林鎮,華崙里,1123,667,456,16,1139,3551,32.08,18.78
彰化縣,二林鎮,東勢里,294,151,143,9,303,958,31.63,15.76
彰化縣,二林鎮,萬合里,287,170,117,12,299,1107,27.01,15.36
彰化縣,二林鎮,大永里,245,120,125,5,250,886,28.22,13.54
彰化縣,二林鎮,原斗里,482,242,240,8,490,1220,40.16,19.84
彰化縣,二林鎮,西斗里,337,176,161,3,340,1041,32.66,16.91
彰化縣,二林鎮,東華里,359,139,220,8,367,967,37.95,14.37
彰化縣,二林鎮,復豐里,200,90,110,6,206,704,29.26,12.78
彰化縣,田尾鄉,田尾村,492,239,253,8,500,1279,39.09,18.69
彰化縣,田尾鄉,豐田村,270,151,119,3,273,793,34.43,19.04
彰化縣,田尾鄉,饒平村,960,493,467,7,967,2570,37.63,19.18
彰化縣,田尾鄉,睦宜村,358,162,196,5,363,1054,34.44,15.37
彰化縣,田尾鄉,福田村,283,124,159,5,288,751,38.35,16.51
彰化縣,田尾鄉,新興村,418,180,238,4,422,1022,41.29,17.61
彰化縣,田尾鄉,北鎮村,367,176,191,8,375,1202,31.2,14.64
彰化縣,田尾鄉,南鎮村,224,96,128,3,227,613,37.03,15.66
彰化縣,田尾鄉,新生村,481,207,274,6,487,1329,36.64,15.58
彰化縣,田尾鄉,南曾村,457,189,268,7,464,1280,36.25,14.77
彰化縣,田尾鄉,北曾村,576,236,340,14,590,1535,38.44,15.37
彰化縣,田尾鄉,溪畔村,439,198,241,5,444,1216,36.51,16.28
彰化縣,田尾鄉,打簾村,670,320,350,8,678,1724,39.33,18.56
彰化縣,田尾鄉,柳鳳村,417,211,206,4,421,941,44.74,22.42
彰化縣,田尾鄉,陸豐村,300,143,157,3,303,870,34.83,16.44
彰化縣,田尾鄉,海豐村,456,204,252,2,458,1365,33.55,14.95
彰化縣,田尾鄉,仁里村,549,255,294,8,557,1594,34.94,16.0
彰化縣,田尾鄉,新厝村,93,45,48,1,94,258,36.43,17.44
彰化縣,田尾鄉,溪頂村,221,86,135,5,226,613,36.87,14.03
彰化縣,田尾鄉,正義村,343,168,175,3,346,875,39.54,19.2
彰化縣,埤頭鄉,和豊村,771,375,396,11,782,2433,32.14,15.41
彰化縣,埤頭鄉,興農村,577,269,308,7,584,1785,32.72,15.07
彰化縣,埤頭鄉,埤頭村,571,216,355,13,584,1565,37.32,13.8
彰化縣,埤頭鄉,豊崙村,640,379,261,16,656,2256,29.08,16.8
彰化縣,埤頭鄉,崙子村,408,197,211,3,411,1230,33.41,16.02
彰化縣,埤頭鄉,永豊村,517,237,280,14,531,1561,34.02,15.18
彰化縣,埤頭鄉,合興村,1175,648,527,10,1185,3254,36.42,19.91
彰化縣,埤頭鄉,平原村,675,348,327,11,686,2210,31.04,15.75
彰化縣,埤頭鄉,崙腳村,234,97,137,6,240,710,33.8,13.66
彰化縣,埤頭鄉,元埔村,206,95,111,0,206,558,36.92,17.03
彰化縣,埤頭鄉,芙朝村,487,250,237,10,497,1486,33.45,16.82
彰化縣,埤頭鄉,新庄村,337,101,236,4,341,1021,33.4,9.89
彰化縣,埤頭鄉,陸嘉村,245,99,146,5,250,807,30.98,12.27
彰化縣,埤頭鄉,竹圍村,355,119,236,5,360,1052,34.22,11.31
彰化縣,埤頭鄉,中和村,509,205,304,4,513,1457,35.21,14.07
彰化縣,埤頭鄉,庄內村,332,124,208,11,343,1056,32.48,11.74
彰化縣,埤頭鄉,大湖村,341,114,227,8,349,913,38.23,12.49
彰化縣,芳苑鄉,芳苑村,251,90,161,6,257,928,27.69,9.7
彰化縣,芳苑鄉,芳中村,146,65,81,3,149,395,37.72,16.46
彰化縣,芳苑鄉,仁愛村,222,117,105,4,226,735,30.75,15.92
彰化縣,芳苑鄉,信義村,131,59,72,3,134,522,25.67,11.3
彰化縣,芳苑鄉,後寮村,231,121,110,3,234,949,24.66,12.75
彰化縣,芳苑鄉,三合村,669,306,363,12,681,2090,32.58,14.64
彰化縣,芳苑鄉,永興村,407,204,203,3,410,1329,30.85,15.35
彰化縣,芳苑鄉,五俊村,101,49,52,3,104,475,21.89,10.32
彰化縣,芳苑鄉,路上村,176,87,89,5,181,630,28.73,13.81
彰化縣,芳苑鄉,路平村,218,121,97,3,221,785,28.15,15.41
彰化縣,芳苑鄉,三成村,229,108,121,4,233,973,23.95,11.1
彰化縣,芳苑鄉,福榮村,182,78,104,2,184,575,32.0,13.57
彰化縣,芳苑鄉,頂廍村,171,76,95,3,174,557,31.24,13.64
彰化縣,芳苑鄉,新街村,196,76,120,6,202,769,26.27,9.88
彰化縣,芳苑鄉,王功村,633,198,435,17,650,2116,30.72,9.36
彰化縣,芳苑鄉,博愛村,242,70,172,6,248,673,36.85,10.4
彰化縣,芳苑鄉,和平村,208,85,123,7,215,727,29.57,11.69
彰化縣,芳苑鄉,民生村,214,69,145,2,216,665,32.48,10.38
彰化縣,芳苑鄉,興仁村,375,121,254,4,379,1278,29.66,9.47
彰化縣,芳苑鄉,新寶村,489,181,308,6,495,1656,29.89,10.93
彰化縣,芳苑鄉,草湖村,445,224,221,5,450,1420,31.69,15.77
彰化縣,芳苑鄉,文津村,234,106,128,3,237,1062,22.32,9.98
彰化縣,芳苑鄉,建平村,590,260,330,2,592,2059,28.75,12.63
彰化縣,芳苑鄉,崙腳村,215,117,98,7,222,762,29.13,15.35
彰化縣,芳苑鄉,新生村,331,155,176,8,339,1304,26.0,11.89
彰化縣,芳苑鄉,漢寶村,952,464,488,13,965,3159,30.55,14.69
彰化縣,大城鄉,潭墘村,314,125,189,4,318,1065,29.86,11.74
彰化縣,大城鄉,上山村,315,194,121,6,321,1069,30.03,18.15
彰化縣,大城鄉,東城村,377,198,179,6,383,1296,29.55,15.28
彰化縣,大城鄉,西城村,224,125,99,2,226,798,28.32,15.66
彰化縣,大城鄉,大城村,334,196,138,7,341,929,36.71,21.1
彰化縣,大城鄉,菜寮村,227,137,90,4,231,1048,22.04,13.07
彰化縣,大城鄉,山腳村,314,169,145,4,318,1256,25.32,13.46
彰化縣,大城鄉,永和村,164,99,65,5,169,662,25.53,14.95
彰化縣,大城鄉,頂庄村,182,96,86,1,183,663,27.6,14.48
彰化縣,大城鄉,公館村,302,179,123,8,310,1045,29.67,17.13
彰化縣,大城鄉,臺西村,225,115,110,5,230,861,26.71,13.36
彰化縣,大城鄉,東港村,276,171,105,2,278,1164,23.88,14.69
彰化縣,大城鄉,西港村,237,154,83,7,244,867,28.14,17.76
彰化縣,大城鄉,豐美村,213,91,122,7,220,845,26.04,10.77
彰化縣,大城鄉,三豐村,109,62,47,6,115,626,18.37,9.9
彰化縣,竹塘鄉,竹元村,387,195,192,3,390,1148,33.97,16.99
彰化縣,竹塘鄉,竹塘村,644,330,314,4,648,1936,33.47,17.05
彰化縣,竹塘鄉,小西村,230,116,114,7,237,699,33.91,16.6
彰化縣,竹塘鄉,民靖村,218,114,104,3,221,753,29.35,15.14
彰化縣,竹塘鄉,五庄村,466,163,303,5,471,1527,30.84,10.67
彰化縣,竹塘鄉,樹腳村,207,69,138,4,211,641,32.92,10.76
彰化縣,竹塘鄉,田頭村,324,137,187,4,328,1052,31.18,13.02
彰化縣,竹塘鄉,新廣村,348,137,211,4,352,1083,32.5,12.65
彰化縣,竹塘鄉,溪墘村,173,65,108,1,174,471,36.94,13.8
彰化縣,竹塘鄉,竹林村,236,110,126,2,238,785,30.32,14.01
彰化縣,竹塘鄉,土庫村,219,102,117,1,220,626,35.14,16.29
彰化縣,竹塘鄉,內新村,187,49,138,2,189,536,35.26,9.14
彰化縣,竹塘鄉,長安村,246,80,166,5,251,750,33.47,10.67
彰化縣,竹塘鄉,永安村,145,50,95,3,148,536,27.61,9.33
彰化縣,溪州鄉,溪厝村,598,244,354,6,604,1828,33.04,13.35
彰化縣,溪州鄉,舊眉村,499,206,293,5,504,1430,35.24,14.41
彰化縣,溪州鄉,柑園村,301,151,150,1,302,1131,26.7,13.35
彰化縣,溪州鄉,水尾村,486,125,361,8,494,1499,32.96,8.34
彰化縣,溪州鄉,坑厝村,251,98,153,2,253,699,36.19,14.02
彰化縣,溪州鄉,圳寮村,464,195,269,5,469,1461,32.1,13.35
彰化縣,溪州鄉,潮洋村,249,113,136,5,254,813,31.24,13.9
彰化縣,溪州鄉,瓦厝村,363,124,239,1,364,839,43.38,14.78
彰化縣,溪州鄉,西畔村,574,219,355,11,585,1977,29.59,11.08
彰化縣,溪州鄉,張厝村,198,72,126,3,201,693,29.0,10.39
彰化縣,溪州鄉,溪州村,584,265,319,7,591,1516,38.98,17.48
彰化縣,溪州鄉,成功村,508,206,302,6,514,1799,28.57,11.45
彰化縣,溪州鄉,菜公村,250,99,151,7,257,831,30.93,11.91
彰化縣,溪州鄉,尾厝村,660,299,361,9,669,1827,36.62,16.37
彰化縣,溪州鄉,大庄村,546,175,371,12,558,1863,29.95,9.39
彰化縣,溪州鄉,三圳村,435,177,258,11,446,1255,35.54,14.1
彰化縣,溪州鄉,東州村,720,303,417,5,725,1915,37.86,15.82
彰化縣,溪州鄉,榮光村,280,143,137,7,287,850,33.76,16.82
彰化縣,溪州鄉,三條村,325,57,268,6,331,846,39.13,6.74
南投縣,南投市,龍泉里,381,186,195,0,381,910,41.87,20.44
南投縣,南投市,康壽里,637,326,311,4,641,1370,46.79,23.8
南投縣,南投市,三民里,332,169,163,1,333,772,43.13,21.89
南投縣,南投市,仁和里,259,112,147,1,260,486,53.5,23.05
南投縣,南投市,南投里,262,124,138,1,263,574,45.82,21.6
南投縣,南投市,彰仁里,194,81,113,2,196,366,53.55,22.13
南投縣,南投市,崇文里,424,210,214,3,427,933,45.77,22.51
南投縣,南投市,漳興里,1089,545,544,9,1098,2566,42.79,21.24
南投縣,南投市,漳和里,2825,1544,1281,26,2851,7006,40.69,22.04
南投縣,南投市,軍功里,1705,901,804,20,1725,4577,37.69,19.69
南投縣,南投市,東山里,146,70,76,4,150,376,39.89,18.62
南投縣,南投市,平和里,2433,1326,1107,23,2456,6024,40.77,22.01
南投縣,南投市,振興里,850,375,475,11,861,2053,41.94,18.27
南投縣,南投市,千秋里,404,198,206,6,410,1008,40.67,19.64
南投縣,南投市,三興里,2214,1250,964,20,2234,5330,41.91,23.45
南投縣,南投市,三和里,1249,672,577,10,1259,2691,46.79,24.97
南投縣,南投市,嘉興里,795,327,468,4,799,2109,37.89,15.5
南投縣,南投市,嘉和里,1668,871,797,17,1685,4405,38.25,19.77
南投縣,南投市,福山里,670,368,302,14,684,1866,36.66,19.72
南投縣,南投市,永興里,253,119,134,8,261,779,33.5,15.28
南投縣,南投市,鳳鳴里,200,64,136,2,202,606,33.33,10.56
南投縣,南投市,鳳山里,340,113,227,5,345,1073,32.15,10.53
南投縣,南投市,平山里,2032,1071,961,17,2049,5387,38.04,19.88
南投縣,南投市,新興里,1780,952,828,15,1795,4997,35.92,19.05
南投縣,南投市,永豐里,1096,545,551,8,1104,2815,39.22,19.36
南投縣,南投市,福興里,1131,538,593,11,1142,3015,37.88,17.84
南投縣,南投市,營北里,3084,2112,972,20,3104,5877,52.82,35.94
南投縣,南投市,營南里,1077,620,457,7,1084,2381,45.53,26.04
南投縣,南投市,內興里,2959,1888,1071,24,2983,6642,44.91,28.43
南投縣,南投市,內新里,567,279,288,7,574,1402,40.94,19.9
南投縣,南投市,光華里,360,292,68,3,363,738,49.19,39.57
南投縣,南投市,光榮里,504,417,87,5,509,993,51.26,41.99
南投縣,南投市,光明里,467,394,73,3,470,908,51.76,43.39
南投縣,南投市,光輝里,286,187,99,4,290,514,56.42,36.38
南投縣,埔里鎮,東門里,1090,601,489,15,1105,2573,42.95,23.36
南投縣,埔里鎮,南門里,404,198,206,4,408,785,51.97,25.22
南投縣,埔里鎮,西門里,1102,587,515,6,1108,2927,37.85,20.05
南投縣,埔里鎮,北門里,832,500,332,6,838,2457,34.11,20.35
南投縣,埔里鎮,同聲里,806,469,337,11,817,2163,37.77,21.68
南投縣,埔里鎮,薰化里,473,256,217,2,475,997,47.64,25.68
南投縣,埔里鎮,清新里,1269,738,531,18,1287,3608,35.67,20.45
南投縣,埔里鎮,大城里,2129,1232,897,19,2148,5729,37.49,21.5
南投縣,埔里鎮,籃城里,403,179,224,1,404,931,43.39,19.23
南投縣,埔里鎮,枇杷里,2611,1624,987,26,2637,7501,35.16,21.65
南投縣,埔里鎮,水頭里,1120,620,500,11,1131,3785,29.88,16.38
南投縣,埔里鎮,麒麟里,325,160,165,4,329,1019,32.29,15.7
南投縣,埔里鎮,珠格里,372,193,179,9,381,1106,34.45,17.45
南投縣,埔里鎮,溪南里,395,223,172,4,399,1116,35.75,19.98
南投縣,埔里鎮,桃米里,352,210,142,4,356,1007,35.35,20.85
南投縣,埔里鎮,成功里,110,53,57,1,111,298,37.25,17.79
南投縣,埔里鎮,南村里,411,225,186,4,415,1324,31.34,16.99
南投縣,埔里鎮,愛蘭里,493,290,203,3,496,1412,35.13,20.54
南投縣,埔里鎮,鐵山里,598,327,271,13,611,1701,35.92,19.22
南投縣,埔里鎮,房里里,456,266,190,3,459,1348,34.05,19.73
南投縣,埔里鎮,向善里,259,132,127,6,265,661,40.09,19.97
南投縣,埔里鎮,一新里,393,259,134,5,398,988,40.28,26.21
南投縣,埔里鎮,廣成里,362,205,157,4,366,1132,32.33,18.11
南投縣,埔里鎮,史港里,221,132,89,1,222,580,38.28,22.76
南投縣,埔里鎮,福興里,336,130,206,3,339,962,35.24,13.51
南投縣,埔里鎮,牛眠里,1010,497,513,9,1019,2818,36.16,17.64
南投縣,埔里鎮,大湳里,612,334,278,11,623,1661,37.51,20.11
南投縣,埔里鎮,蜈蚣里,859,459,400,16,875,2570,34.05,17.86
南投縣,埔里鎮,合成里,572,253,319,7,579,1597,36.26,15.84
南投縣,埔里鎮,北安里,1301,758,543,13,1314,3098,42.41,24.47
南投縣,埔里鎮,杷城里,1001,533,468,13,1014,2585,39.23,20.62
南投縣,埔里鎮,北梅里,1117,669,448,14,1131,3170,35.68,21.1
南投縣,埔里鎮,泰安里,857,520,337,7,864,2070,41.74,25.12
南投縣,草屯鎮,玉峰里,902,527,375,10,912,2084,43.76,25.29
南投縣,草屯鎮,炎峰里,921,485,436,7,928,2059,45.07,23.56
南投縣,草屯鎮,和平里,509,244,265,3,512,1084,47.23,22.51
南投縣,草屯鎮,敦和里,2480,1346,1134,34,2514,6414,39.2,20.99
南投縣,草屯鎮,山腳里,3344,2002,1342,23,3367,7515,44.8,26.64
南投縣,草屯鎮,富寮里,2533,1275,1258,20,2553,6652,38.38,19.17
南投縣,草屯鎮,御史里,2383,1192,1191,32,2415,6108,39.54,19.52
南投縣,草屯鎮,新豐里,1585,803,782,33,1618,4032,40.13,19.92
南投縣,草屯鎮,碧峰里,1675,804,871,18,1693,4524,37.42,17.77
南投縣,草屯鎮,碧洲里,1045,602,443,4,1049,2446,42.89,24.61
南投縣,草屯鎮,復興里,1212,632,580,10,1222,2862,42.7,22.08
南投縣,草屯鎮,上林里,1425,796,629,11,1436,3175,45.23,25.07
南投縣,草屯鎮,新庄里,1448,770,678,11,1459,3702,39.41,20.8
南投縣,草屯鎮,北投里,1183,498,685,16,1199,2951,40.63,16.88
南投縣,草屯鎮,石川里,582,291,291,4,586,1502,39.01,19.37
南投縣,草屯鎮,加老里,938,429,509,6,944,2217,42.58,19.35
南投縣,草屯鎮,北勢里,722,326,396,13,735,1858,39.56,17.55
南投縣,草屯鎮,中原里,896,353,543,8,904,2029,44.55,17.4
南投縣,草屯鎮,南埔里,1551,693,858,8,1559,4072,38.29,17.02
南投縣,草屯鎮,土城里,602,351,251,2,604,1658,36.43,21.17
南投縣,草屯鎮,坪頂里,398,202,196,1,399,1017,39.23,19.86
南投縣,草屯鎮,雙冬里,692,348,344,14,706,2247,31.42,15.49
南投縣,草屯鎮,平林里,404,218,186,7,411,1070,38.41,20.37
南投縣,草屯鎮,中正里,309,164,145,3,312,664,46.99,24.7
南投縣,草屯鎮,中山里,1095,510,585,9,1104,2330,47.38,21.89
南投縣,草屯鎮,明正里,1549,836,713,22,1571,3714,42.3,22.51
南投縣,草屯鎮,新厝里,1422,822,600,17,1439,3215,44.76,25.57
南投縣,竹山鎮,竹山里,846,427,419,10,856,1957,43.74,21.82
南投縣,竹山鎮,中正里,232,115,117,1,233,614,37.95,18.73
南投縣,竹山鎮,中山里,1680,850,830,19,1699,4553,37.32,18.67
南投縣,竹山鎮,雲林里,1331,711,620,9,1340,3463,38.69,20.53
南投縣,竹山鎮,硘磘里,642,317,325,10,652,1752,37.21,18.09
南投縣,竹山鎮,下坪里,462,242,220,10,472,1189,39.7,20.35
南投縣,竹山鎮,桂林里,1271,624,647,15,1286,3652,35.21,17.09
南投縣,竹山鎮,中和里,325,103,222,4,329,894,36.8,11.52
南投縣,竹山鎮,中崎里,448,221,227,8,456,1401,32.55,15.77
南投縣,竹山鎮,德興里,334,181,153,5,339,878,38.61,20.62
南投縣,竹山鎮,延平里,958,426,532,11,969,2802,34.58,15.2
南投縣,竹山鎮,延正里,534,260,274,9,543,1678,32.36,15.49
南投縣,竹山鎮,延山里,317,156,161,3,320,839,38.14,18.59
南投縣,竹山鎮,延和里,1717,857,860,15,1732,4860,35.64,17.63
南投縣,竹山鎮,山崇里,595,272,323,7,602,1818,33.11,14.96
南投縣,竹山鎮,社寮里,469,217,252,9,478,1312,36.43,16.54
南投縣,竹山鎮,中央里,379,172,207,5,384,1132,33.92,15.19
南投縣,竹山鎮,富州里,232,118,114,3,235,595,39.5,19.83
南投縣,竹山鎮,大鞍里,131,77,54,1,132,422,31.28,18.25
南投縣,竹山鎮,田子里,179,85,94,4,183,577,31.72,14.73
南投縣,竹山鎮,福興里,219,130,89,4,223,591,37.73,22.0
南投縣,竹山鎮,鯉魚里,213,107,106,3,216,733,29.47,14.6
南投縣,竹山鎮,瑞竹里,177,93,84,3,180,562,32.03,16.55
南投縣,竹山鎮,坪頂里,162,84,78,0,162,446,36.32,18.83
南投縣,竹山鎮,桶頭里,226,101,125,7,233,865,26.94,11.68
南投縣,竹山鎮,秀林里,262,124,138,4,266,674,39.47,18.4
南投縣,竹山鎮,延祥里,1324,650,674,8,1332,3551,37.51,18.3
南投縣,竹山鎮,竹圍里,829,421,408,9,838,2248,37.28,18.73
南投縣,集集鎮,集集里,446,275,171,6,452,1076,42.01,25.56
南投縣,集集鎮,和平里,330,186,144,7,337,872,38.65,21.33
南投縣,集集鎮,林尾里,196,95,101,3,199,549,36.25,17.3
南投縣,集集鎮,田寮里,387,192,195,5,392,1141,34.36,16.83
南投縣,集集鎮,隘寮里,161,72,89,3,164,463,35.42,15.55
南投縣,集集鎮,玉映里,173,90,83,1,174,472,36.86,19.07
南投縣,集集鎮,吳厝里,341,203,138,5,346,877,39.45,23.15
南投縣,集集鎮,八張里,519,273,246,6,525,1415,37.1,19.29
南投縣,集集鎮,永昌里,353,180,173,4,357,943,37.86,19.09
南投縣,集集鎮,富山里,193,104,89,1,194,544,35.66,19.12
南投縣,集集鎮,廣明里,293,174,119,4,297,889,33.41,19.57
南投縣,名間鄉,南雅村,422,202,220,1,423,1008,41.96,20.04
南投縣,名間鄉,中正村,1319,634,685,15,1334,3391,39.34,18.7
南投縣,名間鄉,中山村,762,364,398,13,775,2202,35.2,16.53
南投縣,名間鄉,濁水村,610,286,324,4,614,1540,39.87,18.57
南投縣,名間鄉,炭寮村,317,134,183,5,322,978,32.92,13.7
南投縣,名間鄉,新民村,367,147,220,11,378,957,39.5,15.36
南投縣,名間鄉,新街村,1587,653,934,22,1609,4169,38.59,15.66
南投縣,名間鄉,東湖村,591,263,328,11,602,1625,37.05,16.18
南投縣,名間鄉,萬丹村,366,138,228,6,372,922,40.35,14.97
南投縣,名間鄉,田仔村,437,174,263,2,439,1233,35.6,14.11
南投縣,名間鄉,大庄村,709,231,478,15,724,1828,39.61,12.64
南投縣,名間鄉,廍下村,308,105,203,2,310,900,34.44,11.67
南投縣,名間鄉,大坑村,250,94,156,1,251,729,34.43,12.89
南投縣,名間鄉,竹圍村,340,130,210,8,348,911,38.2,14.27
南投縣,名間鄉,赤水村,454,182,272,6,460,1160,39.66,15.69
南投縣,名間鄉,三崙村,537,231,306,2,539,1538,35.05,15.02
南投縣,名間鄉,松山村,569,226,343,7,576,1468,39.24,15.4
南投縣,名間鄉,松柏村,419,173,246,7,426,1137,37.47,15.22
南投縣,名間鄉,埔中村,325,148,177,3,328,845,38.82,17.51
南投縣,名間鄉,崁腳村,316,192,124,5,321,874,36.73,21.97
南投縣,名間鄉,新厝村,298,155,143,5,303,739,41.0,20.97
南投縣,名間鄉,新光村,610,275,335,8,618,1737,35.58,15.83
南投縣,名間鄉,仁和村,329,196,133,7,336,867,38.75,22.61
南投縣,鹿谷鄉,鹿谷村,656,346,310,7,663,1813,36.57,19.08
南投縣,鹿谷鄉,初鄉村,493,264,229,5,498,1402,35.52,18.83
南投縣,鹿谷鄉,彰雅村,464,287,177,6,470,1294,36.32,22.18
南投縣,鹿谷鄉,廣興村,687,398,289,7,694,1909,36.35,20.85
南投縣,鹿谷鄉,內湖村,330,184,146,6,336,997,33.7,18.46
南投縣,鹿谷鄉,竹林村,463,253,210,7,470,1463,32.13,17.29
南投縣,鹿谷鄉,竹豐村,329,201,128,4,333,902,36.92,22.28
南投縣,鹿谷鄉,和雅村,221,149,72,4,225,620,36.29,24.03
南投縣,鹿谷鄉,鳳凰村,464,225,239,2,466,1309,35.6,17.19
南投縣,鹿谷鄉,永隆村,543,305,238,9,552,1562,35.34,19.53
南投縣,鹿谷鄉,秀峰村,215,86,129,5,220,747,29.45,11.51
南投縣,鹿谷鄉,清水村,256,119,137,1,257,689,37.3,17.27
南投縣,鹿谷鄉,瑞田村,198,81,117,3,201,710,28.31,11.41
南投縣,中寮鄉,廣興村,260,92,168,2,262,773,33.89,11.9
南投縣,中寮鄉,崁頂村,171,88,83,3,174,470,37.02,18.72
南投縣,中寮鄉,八仙村,268,136,132,2,270,773,34.93,17.59
南投縣,中寮鄉,和興村,197,98,99,2,199,639,31.14,15.34
南投縣,中寮鄉,福盛村,219,112,107,4,223,683,32.65,16.4
南投縣,中寮鄉,永平村,548,286,262,5,553,1678,32.96,17.04
南投縣,中寮鄉,復興村,103,53,50,1,104,287,36.24,18.47
南投縣,中寮鄉,中寮村,216,126,90,3,219,624,35.1,20.19
南投縣,中寮鄉,廣福村,153,57,96,0,153,491,31.16,11.61
南投縣,中寮鄉,永福村,421,237,184,4,425,1319,32.22,17.97
南投縣,中寮鄉,義和村,367,172,195,6,373,1049,35.56,16.4
南投縣,中寮鄉,清水村,239,116,123,11,250,847,29.52,13.7
南投縣,中寮鄉,龍安村,235,86,149,5,240,666,36.04,12.91
南投縣,中寮鄉,龍岩村,221,114,107,2,223,637,35.01,17.9
南投縣,中寮鄉,永和村,170,92,78,3,173,499,34.67,18.44
南投縣,中寮鄉,內城村,164,83,81,1,165,454,36.34,18.28
南投縣,中寮鄉,永芳村,150,74,76,4,154,454,33.92,16.3
南投縣,中寮鄉,爽文村,176,90,86,1,177,477,37.11,18.87
南投縣,魚池鄉,東池村,544,294,250,6,550,1550,35.48,18.97
南投縣,魚池鄉,魚池村,664,354,310,3,667,1908,34.96,18.55
南投縣,魚池鄉,中明村,306,146,160,5,311,994,31.29,14.69
南投縣,魚池鄉,新城村,452,213,239,3,455,1333,34.13,15.98
南投縣,魚池鄉,大林村,342,140,202,7,349,1061,32.89,13.2
南投縣,魚池鄉,東光村,328,162,166,7,335,1242,26.97,13.04
南投縣,魚池鄉,共和村,151,60,91,4,155,501,30.94,11.98
南投縣,魚池鄉,大雁村,205,105,100,2,207,625,33.12,16.8
南投縣,魚池鄉,五城村,230,125,105,5,235,718,32.73,17.41
南投縣,魚池鄉,水社村,299,202,97,3,302,823,36.7,24.54
南投縣,魚池鄉,頭社村,256,124,132,5,261,917,28.46,13.52
南投縣,魚池鄉,武登村,186,114,72,5,191,574,33.28,19.86
南投縣,魚池鄉,日月村,309,161,148,2,311,849,36.63,18.96
南投縣,魚池鄉,新城村、共和村,190,87,103,2,192,541,35.49,16.08
南投縣,國姓鄉,國姓村,544,284,260,18,562,1641,34.25,17.31
南投縣,國姓鄉,石門村,550,333,217,10,560,1676,33.41,19.87
南投縣,國姓鄉,大旗村,184,92,92,2,186,641,29.02,14.35
南投縣,國姓鄉,北港村,528,254,274,4,532,1823,29.18,13.93
南投縣,國姓鄉,長流村,367,230,137,8,375,1346,27.86,17.09
南投縣,國姓鄉,長福村,217,121,96,1,218,688,31.69,17.59
南投縣,國姓鄉,福龜村,605,337,268,10,615,1766,34.82,19.08
南投縣,國姓鄉,乾溝村,249,133,116,7,256,789,32.45,16.86
南投縣,國姓鄉,柑林村,370,228,142,2,372,1117,33.3,20.41
南投縣,國姓鄉,北山村,497,230,267,12,509,1459,34.89,15.76
南投縣,國姓鄉,南港村,477,300,177,9,486,1547,31.42,19.39
南投縣,國姓鄉,大石村,207,119,88,3,210,691,30.39,17.22
南投縣,國姓鄉,長豐村,183,127,56,2,185,730,25.34,17.4
南投縣,水里鄉,水里村,218,124,94,3,221,726,30.44,17.08
南投縣,水里鄉,農富村,185,92,93,2,187,420,44.52,21.9
南投縣,水里鄉,新城村,450,222,228,4,454,1475,30.78,15.05
南投縣,水里鄉,中央村,233,144,89,3,236,596,39.6,24.16
南投縣,水里鄉,城中村,341,208,133,4,345,839,41.12,24.79
南投縣,水里鄉,北埔村,368,210,158,2,370,1004,36.85,20.92
南投縣,水里鄉,鉅工村,366,201,165,1,367,922,39.8,21.8
南投縣,水里鄉,永豐村,431,228,203,11,442,1346,32.84,16.94
南投縣,水里鄉,頂崁村,376,191,185,5,381,1172,32.51,16.3
南投縣,水里鄉,車埕村,165,103,62,4,169,436,38.76,23.62
南投縣,水里鄉,新興村,156,106,50,2,158,621,25.44,17.07
南投縣,水里鄉,新山村,73,41,32,0,73,203,35.96,20.2
南投縣,水里鄉,郡坑村,125,85,40,3,128,318,40.25,26.73
南投縣,水里鄉,上安村,344,199,145,6,350,1065,32.86,18.69
南投縣,水里鄉,民和村,247,113,134,6,253,841,30.08,13.44
南投縣,水里鄉,永興村,125,51,74,2,127,313,40.58,16.29
南投縣,水里鄉,玉峰村,252,102,150,2,254,813,31.24,12.55
南投縣,水里鄉,興隆村,95,51,44,2,97,278,34.89,18.35
南投縣,水里鄉,南光村,513,276,237,4,517,1527,33.86,18.07
南投縣,信義鄉,人和村,223,176,47,9,232,1166,19.9,15.09
南投縣,信義鄉,地利村,254,208,46,4,258,920,28.04,22.61
南投縣,信義鄉,潭南村,122,109,13,3,125,558,22.4,19.53
南投縣,信義鄉,明德村,504,339,165,5,509,1469,34.65,23.08
南投縣,信義鄉,愛國村,140,90,50,0,140,481,29.11,18.71
南投縣,信義鄉,自強村,207,100,107,7,214,713,30.01,14.03
南投縣,信義鄉,羅娜村,332,239,93,10,342,1338,25.56,17.86
南投縣,信義鄉,望美村,322,200,122,8,330,1516,21.77,13.19
南投縣,信義鄉,同富村,411,209,202,6,417,1399,29.81,14.94
南投縣,信義鄉,神木村,159,93,66,6,165,629,26.23,14.79
南投縣,信義鄉,東埔村,219,150,69,1,220,988,22.27,15.18
南投縣,信義鄉,雙龍村,78,58,20,1,79,610,12.95,9.51
南投縣,信義鄉,新鄉村,150,117,33,1,151,587,25.72,19.93
南投縣,信義鄉,豐丘村,158,81,77,1,159,628,25.32,12.9
南投縣,仁愛鄉,法治村,166,127,39,5,171,801,21.35,15.86
南投縣,仁愛鄉,中正村,212,184,28,4,216,907,23.81,20.29
南投縣,仁愛鄉,互助村,351,313,38,7,358,1143,31.32,27.38
南投縣,仁愛鄉,新生村,162,145,17,1,163,398,40.95,36.43
南投縣,仁愛鄉,力行村,98,79,19,2,100,504,19.84,15.67
南投縣,仁愛鄉,發祥村,142,115,27,1,143,749,19.09,15.35
南投縣,仁愛鄉,親愛村,247,207,40,3,250,1118,22.36,18.52
南投縣,仁愛鄉,大同村,542,415,127,7,549,1616,33.97,25.68
南投縣,仁愛鄉,南豐村,378,294,84,3,381,1223,31.15,24.04
南投縣,仁愛鄉,春陽村,242,203,39,1,243,955,25.45,21.26
南投縣,仁愛鄉,精英村,166,132,34,1,167,647,25.81,20.4
南投縣,仁愛鄉,萬豐村,110,89,21,1,111,633,17.54,14.06
南投縣,仁愛鄉,榮興村,22,22,0,0,22,55,40.0,40.0
南投縣,仁愛鄉,翠華村,107,78,29,1,108,507,21.3,15.38
南投縣,仁愛鄉,都達村,111,100,11,2,113,627,18.02,15.95
南投縣,仁愛鄉,德鹿谷村,93,79,14,0,93,614,15.15,12.87
雲林縣,斗六市,忠孝里,630,327,303,5,635,1390,45.68,23.53
雲林縣,斗六市,仁愛里,479,216,263,2,481,1065,45.16,20.28
雲林縣,斗六市,信義里,307,138,169,2,309,609,50.74,22.66
雲林縣,斗六市,四維里,274,128,146,7,281,599,46.91,21.37
雲林縣,斗六市,太平里,336,183,153,5,341,756,45.11,24.21
雲林縣,斗六市,中和里,340,188,152,3,343,767,44.72,24.51
雲林縣,斗六市,光興里,310,150,160,4,314,707,44.41,21.22
雲林縣,斗六市,三平里,1989,1098,891,21,2010,4843,41.5,22.67
雲林縣,斗六市,八德里,1252,648,604,14,1266,3154,40.14,20.55
雲林縣,斗六市,鎮北里,1159,639,520,15,1174,2723,43.11,23.47
雲林縣,斗六市,龍潭里,775,400,375,4,779,1734,44.93,23.07
雲林縣,斗六市,鎮南里,1511,824,687,6,1517,3444,44.05,23.93
雲林縣,斗六市,林頭里,1572,817,755,11,1583,4187,37.81,19.51
雲林縣,斗六市,重光里,821,383,438,6,827,2303,35.91,16.63
雲林縣,斗六市,溝埧里,303,176,127,3,306,657,46.58,26.79
雲林縣,斗六市,江厝里,803,399,404,10,813,2185,37.21,18.26
雲林縣,斗六市,三光里,208,80,128,5,213,538,39.59,14.87
雲林縣,斗六市,崙峯里,986,581,405,7,993,2450,40.53,23.71
雲林縣,斗六市,嘉東里,573,257,316,6,579,1451,39.9,17.71
雲林縣,斗六市,久安里,981,539,442,9,990,2391,41.41,22.54
雲林縣,斗六市,長平里,729,317,412,13,742,1873,39.62,16.92
雲林縣,斗六市,保庄里,2265,1170,1095,23,2288,5409,42.3,21.63
雲林縣,斗六市,虎溪里,1243,596,647,10,1253,3399,36.86,17.53
雲林縣,斗六市,梅林里,715,316,399,10,725,1849,39.21,17.09
雲林縣,斗六市,湖山里,414,174,240,4,418,1112,37.59,15.65
雲林縣,斗六市,榴中里,1682,778,904,22,1704,4461,38.2,17.44
雲林縣,斗六市,榴北里,376,163,213,4,380,1076,35.32,15.15
雲林縣,斗六市,榴南里,690,332,358,8,698,2144,32.56,15.49
雲林縣,斗六市,溪洲里,1187,566,621,10,1197,3219,37.19,17.58
雲林縣,斗六市,長安里,1110,493,617,12,1122,3070,36.55,16.06
雲林縣,斗六市,十三里,423,148,275,8,431,1106,38.97,13.38
雲林縣,斗六市,鎮東里,1025,578,447,7,1032,2279,45.28,25.36
雲林縣,斗六市,鎮西里,1439,730,709,7,1446,3722,38.85,19.61
雲林縣,斗六市,公正里,1154,634,520,17,1171,2734,42.83,23.19
雲林縣,斗六市,社口里,956,516,440,14,970,2247,43.17,22.96
雲林縣,斗六市,公誠里,855,471,384,10,865,2111,40.98,22.31
雲林縣,斗六市,明德里,1479,749,730,18,1497,3620,41.35,20.69
雲林縣,斗六市,成功里,1182,601,581,9,1191,2596,45.88,23.15
雲林縣,斗六市,文化里,964,534,430,6,970,2294,42.28,23.28
雲林縣,斗六市,正心里,823,440,383,4,827,1970,41.98,22.34
雲林縣,斗南鎮,東仁里,508,224,284,5,513,1125,45.6,19.91
雲林縣,斗南鎮,西岐里,888,457,431,5,893,2068,43.18,22.1
雲林縣,斗南鎮,南昌里,813,354,459,13,826,2193,37.67,16.14
雲林縣,斗南鎮,北銘里,612,309,303,6,618,1430,43.22,21.61
雲林縣,斗南鎮,中天里,498,207,291,3,501,1217,41.17,17.01
雲林縣,斗南鎮,舊社里,1012,448,564,9,1021,2651,38.51,16.9
雲林縣,斗南鎮,林子里,505,201,304,4,509,1321,38.53,15.22
雲林縣,斗南鎮,石龜里,318,127,191,3,321,738,43.5,17.21
雲林縣,斗南鎮,靖興里,282,139,143,4,286,860,33.26,16.16
雲林縣,斗南鎮,新南里,261,107,154,5,266,705,37.73,15.18
雲林縣,斗南鎮,阿丹里,386,172,214,7,393,1113,35.31,15.45
雲林縣,斗南鎮,將軍里,621,244,377,9,630,1683,37.43,14.5
雲林縣,斗南鎮,東明里,386,162,224,3,389,970,40.1,16.7
雲林縣,斗南鎮,新光里,1050,409,641,14,1064,2768,38.44,14.78
雲林縣,斗南鎮,田頭里,796,345,451,7,803,2175,36.92,15.86
雲林縣,斗南鎮,明昌里,1288,630,658,13,1301,3315,39.25,19.0
雲林縣,斗南鎮,大東里,319,140,179,6,325,854,38.06,16.39
雲林縣,斗南鎮,埤麻里,306,163,143,4,310,792,39.14,20.58
雲林縣,斗南鎮,西伯里,311,161,150,1,312,823,37.91,19.56
雲林縣,斗南鎮,新崙里,521,211,310,9,530,1470,36.05,14.35
雲林縣,斗南鎮,小東里,560,185,375,9,569,1433,39.71,12.91
雲林縣,斗南鎮,石溪里,326,128,198,11,337,851,39.6,15.04
雲林縣,斗南鎮,大同里,1137,592,545,8,1145,2831,40.45,20.91
雲林縣,斗南鎮,僑真里,831,411,420,10,841,2236,37.61,18.38
雲林縣,虎尾鎮,中山里,366,179,187,2,368,914,40.26,19.58
雲林縣,虎尾鎮,新興里,647,330,317,3,650,1655,39.27,19.94
雲林縣,虎尾鎮,東仁里,1020,537,483,8,1028,2525,40.71,21.27
雲林縣,虎尾鎮,公安里,1182,608,574,9,1191,2771,42.98,21.94
雲林縣,虎尾鎮,德興里,940,536,404,10,950,2473,38.41,21.67
雲林縣,虎尾鎮,西安里,1189,654,535,7,1196,3168,37.75,20.64
雲林縣,虎尾鎮,安慶里,613,333,280,4,617,1361,45.33,24.47
雲林縣,虎尾鎮,平和里,1620,853,767,12,1632,4499,36.27,18.96
雲林縣,虎尾鎮,興南里,870,434,436,9,879,2323,37.84,18.68
雲林縣,虎尾鎮,新吉里,1448,677,771,12,1460,3807,38.35,17.78
雲林縣,虎尾鎮,穎川里,776,392,384,5,781,2017,38.72,19.43
雲林縣,虎尾鎮,延平里,418,208,210,3,421,1123,37.49,18.52
雲林縣,虎尾鎮,三合里,476,242,234,6,482,1313,36.71,18.43
雲林縣,虎尾鎮,北溪里,298,147,151,5,303,828,36.59,17.75
雲林縣,虎尾鎮,墾地里,581,238,343,7,588,1952,30.12,12.19
雲林縣,虎尾鎮,西屯里,505,204,301,3,508,1478,34.37,13.8
雲林縣,虎尾鎮,芳草里,261,74,187,2,263,872,30.16,8.49
雲林縣,虎尾鎮,埒內里,930,369,561,8,938,2607,35.98,14.15
雲林縣,虎尾鎮,堀頭里,296,147,149,5,301,844,35.66,17.42
雲林縣,虎尾鎮,安溪里,577,235,342,14,591,1767,33.45,13.3
雲林縣,虎尾鎮,興中里,585,271,314,9,594,1633,36.37,16.6
雲林縣,虎尾鎮,廉使里,1194,466,728,11,1205,3437,35.06,13.56
雲林縣,虎尾鎮,惠來里,759,323,436,14,773,2304,33.55,14.02
雲林縣,虎尾鎮,頂溪里,825,320,505,12,837,2528,33.11,12.66
雲林縣,虎尾鎮,中溪里,485,207,278,2,487,1339,36.37,15.46
雲林縣,虎尾鎮,下溪里,548,245,303,6,554,1501,36.91,16.32
雲林縣,虎尾鎮,建國里,165,95,70,3,168,515,32.62,18.45
雲林縣,虎尾鎮,立仁里,1393,771,622,7,1400,3651,38.35,21.12
雲林縣,虎尾鎮,東屯里,381,175,206,1,382,1211,31.54,14.45
雲林縣,西螺鎮,振興里,531,161,370,7,538,1509,35.65,10.67
雲林縣,西螺鎮,大園里,651,267,384,11,662,1720,38.49,15.52
雲林縣,西螺鎮,廣福里,755,349,406,3,758,2061,36.78,16.93
雲林縣,西螺鎮,正興里,1112,494,618,5,1117,2893,38.61,17.08
雲林縣,西螺鎮,永安里,150,56,94,1,151,325,46.46,17.23
雲林縣,西螺鎮,中和里,235,87,148,1,236,549,42.99,15.85
雲林縣,西螺鎮,福興里,224,90,134,2,226,568,39.79,15.85
雲林縣,西螺鎮,光華里,372,153,219,7,379,1004,37.75,15.24
雲林縣,西螺鎮,中興里,1065,427,638,9,1074,2870,37.42,14.88
雲林縣,西螺鎮,漢光里,1595,580,1015,15,1610,4547,35.41,12.76
雲林縣,西螺鎮,新安里,455,103,352,8,463,1277,36.26,8.07
雲林縣,西螺鎮,新豐里,527,149,378,6,533,1475,36.14,10.1
雲林縣,西螺鎮,詔安里,370,160,210,10,380,972,39.09,16.46
雲林縣,西螺鎮,河南里,345,122,223,3,348,1105,31.49,11.04
雲林縣,西螺鎮,安定里,552,171,381,5,557,1776,31.36,9.63
雲林縣,西螺鎮,福田里,505,129,376,9,514,1499,34.29,8.61
雲林縣,西螺鎮,大新里,561,187,374,7,568,1573,36.11,11.89
雲林縣,西螺鎮,埤頭里,321,85,236,6,327,872,37.5,9.75
雲林縣,西螺鎮,東興里,388,90,298,5,393,935,42.03,9.63
雲林縣,西螺鎮,廣興里,330,146,184,1,331,854,38.76,17.1
雲林縣,西螺鎮,鹿場里,528,146,382,4,532,1477,36.02,9.88
雲林縣,西螺鎮,頂湳里,379,110,269,10,389,963,40.39,11.42
雲林縣,西螺鎮,下湳里,243,132,111,3,246,809,30.41,16.32
雲林縣,西螺鎮,九隆里,270,87,183,10,280,727,38.51,11.97
雲林縣,西螺鎮,吳厝里,383,120,263,5,388,1287,30.15,9.32
雲林縣,西螺鎮,七座里,307,95,212,8,315,862,36.54,11.02
雲林縣,西螺鎮,公舘里,458,127,331,8,466,1346,34.62,9.44
雲林縣,土庫鎮,忠正里,317,138,179,3,320,765,41.83,18.04
雲林縣,土庫鎮,順天里,329,140,189,2,331,868,38.13,16.13
雲林縣,土庫鎮,宮北里,567,253,314,6,573,1345,42.6,18.81
雲林縣,土庫鎮,越港里,450,235,215,1,451,1052,42.87,22.34
雲林縣,土庫鎮,溪邊里,338,133,205,6,344,1083,31.76,12.28
雲林縣,土庫鎮,興新里,499,205,294,3,502,1401,35.83,14.63
雲林縣,土庫鎮,奮起里,403,168,235,7,410,1267,32.36,13.26
雲林縣,土庫鎮,埤腳里,421,173,248,4,425,1221,34.81,14.17
雲林縣,土庫鎮,大荖里,309,118,191,6,315,854,36.89,13.82
雲林縣,土庫鎮,石廟里,905,419,486,15,920,2844,32.35,14.73
雲林縣,土庫鎮,東平里,634,203,431,12,646,1845,35.01,11.0
雲林縣,土庫鎮,南平里,610,259,351,11,621,1750,35.49,14.8
雲林縣,土庫鎮,北平里,283,88,195,4,287,830,34.58,10.6
雲林縣,土庫鎮,西平里,574,211,363,8,582,1773,32.83,11.9
雲林縣,土庫鎮,後埔里,684,273,411,5,689,2272,30.33,12.02
雲林縣,土庫鎮,崙內里,440,181,259,6,446,1501,29.71,12.06
雲林縣,土庫鎮,新庄里,457,173,284,4,461,1425,32.35,12.14
雲林縣,北港鎮,東陽里,309,111,198,4,313,692,45.23,16.04
雲林縣,北港鎮,光民里,277,77,200,1,278,655,42.44,11.76
雲林縣,北港鎮,東華里,180,80,100,2,182,437,41.65,18.31
雲林縣,北港鎮,南安里,373,137,236,6,379,831,45.61,16.49
雲林縣,北港鎮,中和里,147,48,99,2,149,329,45.29,14.59
雲林縣,北港鎮,義民里,156,67,89,1,157,385,40.78,17.4
雲林縣,北港鎮,共榮里,153,44,109,1,154,355,43.38,12.39
雲林縣,北港鎮,西勢里,369,135,234,1,370,907,40.79,14.88
雲林縣,北港鎮,仁和里,201,81,120,1,202,469,43.07,17.27
雲林縣,北港鎮,賜福里,143,51,92,1,144,312,46.15,16.35
雲林縣,北港鎮,公舘里,204,79,125,2,206,525,39.24,15.05
雲林縣,北港鎮,大同里,438,164,274,2,440,1132,38.87,14.49
雲林縣,北港鎮,仁安里,202,95,107,5,207,425,48.71,22.35
雲林縣,北港鎮,華勝里,1914,745,1169,19,1933,4762,40.59,15.64
雲林縣,北港鎮,光復里,629,301,328,6,635,1679,37.82,17.93
雲林縣,北港鎮,新街里,2353,1019,1334,25,2378,6248,38.06,16.31
雲林縣,北港鎮,劉厝里,402,118,284,1,403,1122,35.92,10.52
雲林縣,北港鎮,府番里,232,108,124,3,235,794,29.6,13.6
雲林縣,北港鎮,草湖里,393,104,289,8,401,1344,29.84,7.74
雲林縣,北港鎮,溝皂里,384,117,267,4,388,1120,34.64,10.45
雲林縣,北港鎮,後溝里,338,100,238,5,343,969,35.4,10.32
雲林縣,北港鎮,番溝里,232,69,163,5,237,760,31.18,9.08
雲林縣,北港鎮,大北里,174,44,130,3,177,537,32.96,8.19
雲林縣,北港鎮,好收里,534,180,354,9,543,1571,34.56,11.46
雲林縣,北港鎮,樹腳里,1111,413,698,7,1118,2928,38.18,14.11
雲林縣,北港鎮,扶朝里,417,76,341,4,421,958,43.95,7.93
雲林縣,北港鎮,水埔里,153,47,106,0,153,470,32.55,10.0
雲林縣,北港鎮,新厝里,128,46,82,5,133,380,35.0,12.11
雲林縣,古坑鄉,水碓村,432,189,243,4,436,1190,36.64,15.88
雲林縣,古坑鄉,田心村,416,226,190,5,421,1080,38.98,20.93
雲林縣,古坑鄉,高林村,399,153,246,5,404,1106,36.53,13.83
雲林縣,古坑鄉,荷苞村,491,228,263,8,499,1397,35.72,16.32
雲林縣,古坑鄉,東和村,1047,441,606,12,1059,3146,33.66,14.02
雲林縣,古坑鄉,新庄村,584,215,369,9,593,1472,40.29,14.61
雲林縣,古坑鄉,棋盤村,695,246,449,14,709,2048,34.62,12.01
雲林縣,古坑鄉,華山村,218,84,134,0,218,708,30.79,11.86
雲林縣,古坑鄉,華南村,104,29,75,1,105,278,37.77,10.43
雲林縣,古坑鄉,永光村,683,308,375,9,692,2109,32.81,14.6
雲林縣,古坑鄉,桂林村,341,105,236,3,344,1061,32.42,9.9
雲林縣,古坑鄉,崁腳村,361,178,183,5,366,1155,31.69,15.41
雲林縣,古坑鄉,樟湖村,104,45,59,1,105,429,24.48,10.49
雲林縣,古坑鄉,草嶺村,195,85,110,4,199,543,36.65,15.65
雲林縣,古坑鄉,永昌村,748,335,413,12,760,2065,36.8,16.22
雲林縣,古坑鄉,麻園村,329,118,211,6,335,761,44.02,15.51
雲林縣,古坑鄉,古坑村,783,379,404,5,788,2241,35.16,16.91
雲林縣,古坑鄉,朝陽村,764,372,392,13,777,2080,37.36,17.88
雲林縣,古坑鄉,西平村,582,248,334,2,584,1501,38.91,16.52
雲林縣,古坑鄉,湳仔村,246,114,132,5,251,672,37.35,16.96
雲林縣,大埤鄉,北和村,288,125,163,3,291,737,39.48,16.96
雲林縣,大埤鄉,南和村,806,308,498,11,817,2148,38.04,14.34
雲林縣,大埤鄉,大德村,352,154,198,3,355,959,37.02,16.06
雲林縣,大埤鄉,松竹村,327,84,243,3,330,908,36.34,9.25
雲林縣,大埤鄉,尚義村,664,258,406,12,676,1893,35.71,13.63
雲林縣,大埤鄉,嘉興村,671,270,401,10,681,1830,37.21,14.75
雲林縣,大埤鄉,豐田村,577,235,342,8,585,1532,38.19,15.34
雲林縣,大埤鄉,三結村,383,131,252,7,390,1179,33.08,11.11
雲林縣,大埤鄉,吉田村,238,70,168,5,243,716,33.94,9.78
雲林縣,大埤鄉,豐岡村,198,90,108,2,200,583,34.31,15.44
雲林縣,大埤鄉,聯美村,323,127,196,6,329,1045,31.48,12.15
雲林縣,大埤鄉,怡然村,273,122,151,3,276,743,37.15,16.42
雲林縣,大埤鄉,北鎮村,241,84,157,6,247,670,36.87,12.54
雲林縣,大埤鄉,興安村,237,85,152,2,239,669,35.72,12.71
雲林縣,大埤鄉,西鎮村,222,89,133,3,225,701,32.1,12.7
雲林縣,莿桐鄉,莿桐村,1666,665,1001,21,1687,4116,40.99,16.16
雲林縣,莿桐鄉,甘厝村,334,97,237,5,339,864,39.24,11.23
雲林縣,莿桐鄉,甘西村,588,181,407,8,596,1530,38.95,11.83
雲林縣,莿桐鄉,興桐村,499,186,313,8,507,1177,43.08,15.8
雲林縣,莿桐鄉,義和村,374,112,262,9,383,1068,35.86,10.49
雲林縣,莿桐鄉,埔子村,751,242,509,7,758,2015,37.62,12.01
雲林縣,莿桐鄉,大美村,1190,503,687,9,1199,3053,39.27,16.48
雲林縣,莿桐鄉,埔尾村,521,202,319,9,530,1250,42.4,16.16
雲林縣,莿桐鄉,饒平村,392,142,250,9,401,1135,35.33,12.51
雲林縣,莿桐鄉,興貴村,686,265,421,11,697,1882,37.04,14.08
雲林縣,莿桐鄉,四合村,627,265,362,8,635,1725,36.81,15.36
雲林縣,莿桐鄉,麻園村,494,199,295,14,508,1453,34.96,13.7
雲林縣,莿桐鄉,五華村,466,161,305,6,472,1313,35.95,12.26
雲林縣,莿桐鄉,六合村,670,204,466,18,688,1767,38.94,11.54
雲林縣,林內鄉,林南村,358,174,184,6,364,1004,36.25,17.33
雲林縣,林內鄉,林中村,1292,590,702,21,1313,3548,37.01,16.63
雲林縣,林內鄉,林北村,763,313,450,10,773,2097,36.86,14.93
雲林縣,林內鄉,坪頂村,171,91,80,4,175,505,34.65,18.02
雲林縣,林內鄉,林茂村,289,133,156,3,292,802,36.41,16.58
雲林縣,林內鄉,九芎村,829,375,454,11,840,2594,32.38,14.46
雲林縣,林內鄉,湖本村,227,87,140,1,228,627,36.36,13.88
雲林縣,林內鄉,烏塗村,383,177,206,8,391,1115,35.07,15.87
雲林縣,林內鄉,烏麻村,345,187,158,4,349,1016,34.35,18.41
雲林縣,林內鄉,重興村,640,225,415,8,648,1798,36.04,12.51
雲林縣,二崙鄉,崙東村,524,216,308,8,532,1442,36.89,14.98
雲林縣,二崙鄉,崙西村,626,253,373,7,633,1698,37.28,14.9
雲林縣,二崙鄉,來惠村,522,165,357,8,530,1596,33.21,10.34
雲林縣,二崙鄉,三和村,504,165,339,10,514,1474,34.87,11.19
雲林縣,二崙鄉,湳仔村,412,186,226,6,418,1126,37.12,16.52
雲林縣,二崙鄉,田尾村,646,218,428,5,651,1839,35.4,11.85
雲林縣,二崙鄉,定安村,301,97,204,6,307,861,35.66,11.27
雲林縣,二崙鄉,大華村,341,87,254,3,344,873,39.4,9.97
雲林縣,二崙鄉,義庄村,279,55,224,3,282,748,37.7,7.35
雲林縣,二崙鄉,楊賢村,456,107,349,7,463,1464,31.63,7.31
雲林縣,二崙鄉,港後村,616,175,441,9,625,1782,35.07,9.82
雲林縣,二崙鄉,大義村,272,77,195,4,276,821,33.62,9.38
雲林縣,二崙鄉,油車村,650,233,417,8,658,1719,38.28,13.55
雲林縣,二崙鄉,大庄村,405,122,283,10,415,1223,33.93,9.98
雲林縣,二崙鄉,庄西村,231,70,161,1,232,907,25.58,7.72
雲林縣,二崙鄉,大同村,279,77,202,4,283,824,34.34,9.34
雲林縣,二崙鄉,復興村,263,86,177,5,268,983,27.26,8.75
雲林縣,二崙鄉,永定村,561,174,387,3,564,1406,40.11,12.38
雲林縣,崙背鄉,東明村,421,170,251,3,424,1134,37.39,14.99
雲林縣,崙背鄉,西榮村,502,227,275,10,512,1437,35.63,15.8
雲林縣,崙背鄉,南陽村,832,378,454,4,836,2263,36.94,16.7
雲林縣,崙背鄉,崙前村,736,244,492,6,742,2078,35.71,11.74
雲林縣,崙背鄉,羅厝村,741,261,480,13,754,2042,36.92,12.78
雲林縣,崙背鄉,港尾村,420,129,291,8,428,1250,34.24,10.32
雲林縣,崙背鄉,阿勸村,589,250,339,9,598,2022,29.57,12.36
雲林縣,崙背鄉,五魁村,256,168,88,9,265,782,33.89,21.48
雲林縣,崙背鄉,大有村,433,175,258,12,445,1484,29.99,11.79
雲林縣,崙背鄉,豐榮村,502,190,312,6,508,1710,29.71,11.11
雲林縣,崙背鄉,草湖村,425,189,236,6,431,1413,30.5,13.38
雲林縣,崙背鄉,舊庄村,270,104,166,2,272,1102,24.68,9.44
雲林縣,崙背鄉,水尾村,444,118,326,4,448,1181,37.93,9.99
雲林縣,崙背鄉,枋南村,234,90,144,3,237,749,31.64,12.02
雲林縣,麥寮鄉,麥津村,1122,587,535,11,1133,4277,26.49,13.72
雲林縣,麥寮鄉,麥豐村,1929,1017,912,24,1953,7460,26.18,13.63
雲林縣,麥寮鄉,瓦磘村,513,186,327,10,523,1968,26.58,9.45
雲林縣,麥寮鄉,興華村,755,312,443,10,765,2867,26.68,10.88
雲林縣,麥寮鄉,崙後村,634,344,290,8,642,2721,23.59,12.64
雲林縣,麥寮鄉,後安村,658,385,273,10,668,3051,21.89,12.62
雲林縣,麥寮鄉,海豐村,508,246,262,6,514,2216,23.19,11.1
雲林縣,麥寮鄉,三盛村,515,232,283,7,522,2141,24.38,10.84
雲林縣,麥寮鄉,橋頭村,1007,468,539,14,1021,4026,25.36,11.62
雲林縣,麥寮鄉,新吉村,300,129,171,5,305,1156,26.38,11.16
雲林縣,麥寮鄉,施厝村,929,390,539,18,947,3617,26.18,10.78
雲林縣,麥寮鄉,雷厝村,544,261,283,12,556,2222,25.02,11.75
雲林縣,麥寮鄉,中興村,368,184,184,3,371,1548,23.97,11.89
雲林縣,東勢鄉,東南村,559,300,259,6,565,1442,39.18,20.8
雲林縣,東勢鄉,東北村,383,190,193,5,388,1155,33.59,16.45
雲林縣,東勢鄉,嘉隆村,438,179,259,5,443,1536,28.84,11.65
雲林縣,東勢鄉,復興村,198,91,107,2,200,511,39.14,17.81
雲林縣,東勢鄉,月眉村,339,113,226,4,343,1160,29.57,9.74
雲林縣,東勢鄉,程海村,182,76,106,2,184,532,34.59,14.29
雲林縣,東勢鄉,龍潭村,265,78,187,6,271,778,34.83,10.03
雲林縣,東勢鄉,安南村,211,82,129,3,214,812,26.35,10.1
雲林縣,東勢鄉,昌南村,280,113,167,3,283,825,34.3,13.7
雲林縣,東勢鄉,同安村,553,258,295,14,567,1857,30.53,13.89
雲林縣,東勢鄉,新坤村,314,143,171,1,315,1015,31.03,14.09
雲林縣,東勢鄉,四美村,289,127,162,6,295,989,29.83,12.84
雲林縣,褒忠鄉,中民村,697,302,395,9,706,1848,38.2,16.34
雲林縣,褒忠鄉,埔姜村,523,233,290,7,530,1415,37.46,16.47
雲林縣,褒忠鄉,中勝村,518,204,314,6,524,1455,36.01,14.02
雲林縣,褒忠鄉,新湖村,436,147,289,9,445,1158,38.43,12.69
雲林縣,褒忠鄉,馬鳴村,507,184,323,8,515,1437,35.84,12.8
雲林縣,褒忠鄉,有才村,293,109,184,6,299,806,37.1,13.52
雲林縣,褒忠鄉,田洋村,277,115,162,5,282,774,36.43,14.86
雲林縣,褒忠鄉,龍岩村,390,186,204,4,394,1187,33.19,15.67
雲林縣,褒忠鄉,潮厝村,307,129,178,8,315,853,36.93,15.12
雲林縣,臺西鄉,台西村,413,245,168,9,422,1177,35.85,20.82
雲林縣,臺西鄉,海北村,320,176,144,7,327,1060,30.85,16.6
雲林縣,臺西鄉,海南村,312,160,152,5,317,1093,29.0,14.64
雲林縣,臺西鄉,海口村,493,272,221,8,501,1980,25.3,13.74
雲林縣,臺西鄉,溪頂村,363,163,200,8,371,1449,25.6,11.25
雲林縣,臺西鄉,牛厝村,454,200,254,13,467,1828,25.55,10.94
雲林縣,臺西鄉,泉州村,155,74,81,5,160,592,27.03,12.5
雲林縣,臺西鄉,光華村,220,108,112,4,224,672,33.33,16.07
雲林縣,臺西鄉,五榔村,139,42,97,4,143,450,31.78,9.33
雲林縣,臺西鄉,山寮村,211,124,87,2,213,811,26.26,15.29
雲林縣,臺西鄉,富琦村,386,194,192,4,390,1466,26.6,13.23
雲林縣,臺西鄉,永豐村,370,183,187,3,373,1332,28.0,13.74
雲林縣,臺西鄉,和豐村,759,357,402,19,778,2935,26.51,12.16
雲林縣,臺西鄉,蚊港村,428,247,181,10,438,1741,25.16,14.19
雲林縣,臺西鄉,五港村,464,253,211,5,469,1781,26.33,14.21
雲林縣,元長鄉,長南村,1021,379,642,9,1030,3218,32.01,11.78
雲林縣,元長鄉,長北村,487,178,309,8,495,1454,34.04,12.24
雲林縣,元長鄉,子茂村,408,144,264,6,414,1308,31.65,11.01
雲林縣,元長鄉,後湖村,229,70,159,6,235,705,33.33,9.93
雲林縣,元長鄉,山內村,290,122,168,4,294,936,31.41,13.03
雲林縣,元長鄉,合和村,297,98,199,5,302,1030,29.32,9.51
雲林縣,元長鄉,五塊村,288,136,152,4,292,890,32.81,15.28
雲林縣,元長鄉,潭西村,256,64,192,10,266,715,37.2,8.95
雲林縣,元長鄉,潭東村,174,85,89,5,179,570,31.4,14.91
雲林縣,元長鄉,客厝村,221,106,115,1,222,836,26.56,12.68
雲林縣,元長鄉,卓運村,138,30,108,2,140,351,39.89,8.55
雲林縣,元長鄉,頂寮村,294,97,197,3,297,1112,26.71,8.72
雲林縣,元長鄉,下寮村,439,180,259,7,446,1457,30.61,12.35
雲林縣,元長鄉,龍岩村,317,71,246,0,317,958,33.09,7.41
雲林縣,元長鄉,西莊村,249,86,163,4,253,813,31.12,10.58
雲林縣,元長鄉,鹿北村,307,109,198,4,311,1127,27.6,9.67
雲林縣,元長鄉,鹿南村,262,99,163,6,268,816,32.84,12.13
雲林縣,元長鄉,瓦磘村,414,138,276,3,417,1472,28.33,9.38
雲林縣,元長鄉,內寮村,172,54,118,1,173,578,29.93,9.34
雲林縣,元長鄉,崙仔村,191,74,117,9,200,803,24.91,9.22
雲林縣,元長鄉,新吉村,227,92,135,1,228,686,33.24,13.41
雲林縣,四湖鄉,四湖村,585,266,319,4,589,1728,34.09,15.39
雲林縣,四湖鄉,新庄村,185,69,116,1,186,626,29.71,11.02
雲林縣,四湖鄉,溪底村,259,103,156,0,259,902,28.71,11.42
雲林縣,四湖鄉,鹿場村,257,95,162,6,263,883,29.78,10.76
雲林縣,四湖鄉,湖西村,748,378,370,16,764,2201,34.71,17.17
雲林縣,四湖鄉,施湖村,293,145,148,1,294,1152,25.52,12.59
雲林縣,四湖鄉,湖寮村,187,74,113,4,191,712,26.83,10.39
雲林縣,四湖鄉,蔡厝村,209,84,125,4,213,828,25.72,10.14
雲林縣,四湖鄉,飛沙村,226,110,116,1,227,846,26.83,13.0
雲林縣,四湖鄉,三姓村,84,32,52,2,86,352,24.43,9.09
雲林縣,四湖鄉,內湖村,189,69,120,3,192,743,25.84,9.29
雲林縣,四湖鄉,羊調村,222,104,118,5,227,898,25.28,11.58
雲林縣,四湖鄉,崙北村,380,163,217,4,384,1669,23.01,9.77
雲林縣,四湖鄉,崙南村,178,83,95,2,180,782,23.02,10.61
雲林縣,四湖鄉,廣溝村,135,67,68,3,138,683,20.2,9.81
雲林縣,四湖鄉,萡子村,238,73,165,6,244,878,27.79,8.31
雲林縣,四湖鄉,林厝村,278,102,176,6,284,1016,27.95,10.04
雲林縣,四湖鄉,林東村,215,104,111,10,225,958,23.49,10.86
雲林縣,四湖鄉,溪尾村,164,83,81,5,169,724,23.34,11.46
雲林縣,四湖鄉,飛東村,157,52,105,3,160,533,30.02,9.76
雲林縣,四湖鄉,萡東村,268,53,215,7,275,1007,27.31,5.26
雲林縣,口湖鄉,湖東村,377,172,205,6,383,1198,31.97,14.36
雲林縣,口湖鄉,口湖村,349,149,200,6,355,1068,33.24,13.95
雲林縣,口湖鄉,頂湖村,167,72,95,0,167,614,27.2,11.73
雲林縣,口湖鄉,埔北村,262,79,183,3,265,851,31.14,9.28
雲林縣,口湖鄉,埔南村,254,80,174,4,258,694,37.18,11.53
雲林縣,口湖鄉,謝厝村,349,82,267,4,353,973,36.28,8.43
雲林縣,口湖鄉,蚵寮村,402,101,301,13,415,1405,29.54,7.19
雲林縣,口湖鄉,下崙村,546,178,368,8,554,2020,27.43,8.81
雲林縣,口湖鄉,崙中村,403,134,269,8,411,1473,27.9,9.1
雲林縣,口湖鄉,崙東村,396,153,243,8,404,1410,28.65,10.85
雲林縣,口湖鄉,青蚶村,141,40,101,3,144,511,28.18,7.83
雲林縣,口湖鄉,港東村,428,153,275,6,434,1493,29.07,10.25
雲林縣,口湖鄉,港西村,257,90,167,3,260,806,32.26,11.17
雲林縣,口湖鄉,台子村,637,94,543,9,646,1888,34.22,4.98
雲林縣,口湖鄉,成龍村,282,105,177,5,287,896,32.03,11.72
雲林縣,口湖鄉,湖口村,297,70,227,5,302,980,30.82,7.14
雲林縣,口湖鄉,水井村,327,116,211,10,337,925,36.43,12.54
雲林縣,口湖鄉,後厝村,230,78,152,2,232,686,33.82,11.37
雲林縣,口湖鄉,梧南村,662,192,470,6,668,1773,37.68,10.83
雲林縣,口湖鄉,梧北村,484,100,384,5,489,1154,42.37,8.67
雲林縣,口湖鄉,過港村,186,68,118,3,189,595,31.76,11.43
雲林縣,水林鄉,水北村,651,225,426,7,658,2131,30.88,10.56
雲林縣,水林鄉,水南村,725,243,482,6,731,1971,37.09,12.33
雲林縣,水林鄉,海埔村,351,75,276,10,361,969,37.25,7.74
雲林縣,水林鄉,土厝村,406,88,318,7,413,1149,35.94,7.66
雲林縣,水林鄉,春埔村,318,88,230,3,321,944,34.0,9.32
雲林縣,水林鄉,西井村,194,86,108,5,199,598,33.28,14.38
雲林縣,水林鄉,車港村,181,63,118,5,186,597,31.16,10.55
雲林縣,水林鄉,蘇秦村,299,83,216,4,303,943,32.13,8.8
雲林縣,水林鄉,灣東村,180,89,91,2,182,603,30.18,14.76
雲林縣,水林鄉,灣西村,289,112,177,2,291,905,32.15,12.38
雲林縣,水林鄉,萬興村,210,46,164,4,214,680,31.47,6.76
雲林縣,水林鄉,尖山村,200,45,155,4,204,627,32.54,7.18
雲林縣,水林鄉,大山村,363,97,266,4,367,1006,36.48,9.64
雲林縣,水林鄉,大溝村,337,98,239,10,347,967,35.88,10.13
雲林縣,水林鄉,順興村,266,71,195,5,271,803,33.75,8.84
雲林縣,水林鄉,蕃薯村,321,93,228,4,325,927,35.06,10.03
雲林縣,水林鄉,山腳村,244,65,179,7,251,776,32.35,8.38
雲林縣,水林鄉,松北村,284,113,171,7,291,989,29.42,11.43
雲林縣,水林鄉,松中村,187,45,142,2,189,484,39.05,9.3
雲林縣,水林鄉,松西村,195,39,156,5,200,647,30.91,6.03
雲林縣,水林鄉,瓊埔村,222,39,183,7,229,655,34.96,5.95
雲林縣,水林鄉,塭底村,188,43,145,5,193,653,29.56,6.58
雲林縣,水林鄉,後寮村,227,74,153,4,231,653,35.38,11.33
雲林縣,水林鄉,溪墘村,244,89,155,13,257,765,33.59,11.63
嘉義縣,太保市,太保里,873,391,482,8,881,2315,38.06,16.89
嘉義縣,太保市,後庄里,188,44,144,2,190,466,40.77,9.44
嘉義縣,太保市,前潭里,615,199,416,7,622,1453,42.81,13.7
嘉義縣,太保市,後潭里,731,273,458,5,736,1685,43.68,16.2
嘉義縣,太保市,梅埔里,471,178,293,10,481,1133,42.45,15.71
嘉義縣,太保市,春珠里,380,116,264,6,386,1105,34.93,10.5
嘉義縣,太保市,崙頂里,329,130,199,4,333,817,40.76,15.91
嘉義縣,太保市,東勢里,769,330,439,4,773,1799,42.97,18.34
嘉義縣,太保市,新埤里,482,139,343,15,497,1244,39.95,11.17
嘉義縣,太保市,舊埤里,905,335,570,11,916,2556,35.84,13.11
嘉義縣,太保市,田尾里,292,97,195,2,294,724,40.61,13.4
嘉義縣,太保市,港尾里,218,84,134,3,221,547,40.4,15.36
嘉義縣,太保市,過溝里,1396,462,934,8,1404,3489,40.24,13.24
嘉義縣,太保市,麻寮里,1675,619,1056,19,1694,4625,36.63,13.38
嘉義縣,太保市,南新里,709,204,505,7,716,1819,39.36,11.21
嘉義縣,太保市,北新里,1112,398,714,15,1127,3112,36.21,12.79
嘉義縣,太保市,埤鄉里,270,103,167,4,274,679,40.35,15.17
嘉義縣,太保市,安仁里,1040,470,570,6,1046,2639,39.64,17.81
嘉義縣,朴子市,安福里,720,345,375,7,727,1887,38.53,18.28
嘉義縣,朴子市,平和里,941,426,515,11,952,2322,41.0,18.35
嘉義縣,朴子市,內厝里,480,161,319,4,484,1092,44.32,14.74
嘉義縣,朴子市,開元里,177,60,117,2,179,377,47.48,15.92
嘉義縣,朴子市,順天里,260,103,157,3,263,610,43.11,16.89
嘉義縣,朴子市,中正里,294,128,166,4,298,618,48.22,20.71
嘉義縣,朴子市,博厚里,323,123,200,5,328,819,40.05,15.02
嘉義縣,朴子市,文化里,705,299,406,4,709,1676,42.3,17.84
嘉義縣,朴子市,永和里,931,309,622,11,942,2498,37.71,12.37
嘉義縣,朴子市,竹圍里,1733,748,985,13,1746,4243,41.15,17.63
嘉義縣,朴子市,新寮里,241,84,157,0,241,669,36.02,12.56
嘉義縣,朴子市,双溪里,189,65,124,3,192,608,31.58,10.69
嘉義縣,朴子市,溪口里,272,88,184,3,275,768,35.81,11.46
嘉義縣,朴子市,德興里,410,104,306,4,414,1015,40.79,10.25
嘉義縣,朴子市,仁和里,670,296,374,6,676,1769,38.21,16.73
嘉義縣,朴子市,大鄉里,1100,393,707,23,1123,3190,35.2,12.32
嘉義縣,朴子市,大葛里,1080,436,644,15,1095,2926,37.42,14.9
嘉義縣,朴子市,佳禾里,246,88,158,6,252,742,33.96,11.86
嘉義縣,朴子市,竹村里,412,156,256,4,416,1040,40.0,15.0
嘉義縣,朴子市,崁前里,327,95,232,7,334,870,38.39,10.92
嘉義縣,朴子市,順安里,114,37,77,1,115,246,46.75,15.04
嘉義縣,朴子市,崁後里,270,79,191,5,275,709,38.79,11.14
嘉義縣,朴子市,德家里,264,85,179,2,266,767,34.68,11.08
嘉義縣,朴子市,新庄里,269,128,141,4,273,678,40.27,18.88
嘉義縣,朴子市,梅華里,416,82,334,6,422,1019,41.41,8.05
嘉義縣,朴子市,松華里,422,92,330,7,429,1190,36.05,7.73
嘉義縣,朴子市,南竹里,194,30,164,5,199,486,40.95,6.17
嘉義縣,布袋鎮,岱江里,230,117,113,2,232,593,39.12,19.73
嘉義縣,布袋鎮,九龍里,143,70,73,4,147,356,41.29,19.66
嘉義縣,布袋鎮,岑海里,781,348,433,21,802,2143,37.42,16.24
嘉義縣,布袋鎮,興中里,387,165,222,2,389,1064,36.56,15.51
嘉義縣,布袋鎮,光復里,680,320,360,10,690,1593,43.31,20.09
嘉義縣,布袋鎮,見龍里,301,108,193,1,302,860,35.12,12.56
嘉義縣,布袋鎮,新厝里,199,99,100,6,205,683,30.01,14.49
嘉義縣,布袋鎮,龍江里,228,94,134,4,232,742,31.27,12.67
嘉義縣,布袋鎮,新岑里,390,97,293,11,401,920,43.59,10.54
嘉義縣,布袋鎮,新民里,382,142,240,3,385,1287,29.91,11.03
嘉義縣,布袋鎮,復興里,758,266,492,7,765,2276,33.61,11.69
嘉義縣,布袋鎮,好美里,332,113,219,8,340,1106,30.74,10.22
嘉義縣,布袋鎮,永安里,360,173,187,9,369,1090,33.85,15.87
嘉義縣,布袋鎮,東港里,686,240,446,10,696,1861,37.4,12.9
嘉義縣,布袋鎮,江山里,105,41,64,1,106,281,37.72,14.59
嘉義縣,布袋鎮,菜舖里,141,53,88,2,143,385,37.14,13.77
嘉義縣,布袋鎮,考試里,127,42,85,0,127,288,44.1,14.58
嘉義縣,布袋鎮,振寮里,238,126,112,4,242,713,33.94,17.67
嘉義縣,布袋鎮,西安里,420,160,260,6,426,1117,38.14,14.32
嘉義縣,布袋鎮,東安里,538,148,390,8,546,1286,42.46,11.51
嘉義縣,布袋鎮,中安里,467,136,331,9,476,1350,35.26,10.07
嘉義縣,布袋鎮,樹林里,193,68,125,6,199,518,38.42,13.13
嘉義縣,布袋鎮,貴舍里,236,56,180,3,239,632,37.82,8.86
嘉義縣,大林鎮,東林里,215,87,128,2,217,467,46.47,18.63
嘉義縣,大林鎮,西林里,811,325,486,7,818,1816,45.04,17.9
嘉義縣,大林鎮,吉林里,383,175,208,4,387,885,43.73,19.77
嘉義縣,大林鎮,平林里,2371,1057,1314,24,2395,5889,40.67,17.95
嘉義縣,大林鎮,明華里,477,164,313,9,486,1127,43.12,14.55
嘉義縣,大林鎮,明和里,656,293,363,9,665,1783,37.3,16.43
嘉義縣,大林鎮,排路里,268,67,201,1,269,595,45.21,11.26
嘉義縣,大林鎮,西結里,257,61,196,5,262,703,37.27,8.68
嘉義縣,大林鎮,湖北里,264,89,175,5,269,612,43.95,14.54
嘉義縣,大林鎮,大糖里,74,39,35,1,75,184,40.76,21.2
嘉義縣,大林鎮,大美里,547,242,305,10,557,1563,35.64,15.48
嘉義縣,大林鎮,過溪里,521,196,325,11,532,1405,37.86,13.95
嘉義縣,大林鎮,中坑里,530,199,331,4,534,1327,40.24,15.0
嘉義縣,大林鎮,上林里,317,125,192,6,323,793,40.73,15.76
嘉義縣,大林鎮,中林里,637,187,450,15,652,1546,42.17,12.1
嘉義縣,大林鎮,三和里,729,296,433,11,740,2009,36.83,14.73
嘉義縣,大林鎮,溝背里,346,118,228,4,350,905,38.67,13.04
嘉義縣,大林鎮,義和里,253,124,129,5,258,656,39.33,18.9
嘉義縣,大林鎮,內林里,272,121,151,5,277,644,43.01,18.79
嘉義縣,大林鎮,三角里,292,142,150,4,296,817,36.23,17.38
嘉義縣,大林鎮,三村里,343,140,203,1,344,820,41.95,17.07
嘉義縣,民雄鄉,東榮村,937,412,525,7,944,2300,41.04,17.91
嘉義縣,民雄鄉,中樂村,676,322,354,7,683,1528,44.7,21.07
嘉義縣,民雄鄉,西安村,1399,542,857,9,1408,3338,42.18,16.24
嘉義縣,民雄鄉,寮頂村,874,324,550,9,883,2158,40.92,15.01
嘉義縣,民雄鄉,福權村,676,221,455,9,685,1567,43.71,14.1
嘉義縣,民雄鄉,東湖村,636,257,379,13,649,1827,35.52,14.07
嘉義縣,民雄鄉,頂崙村,562,335,227,11,573,1469,39.01,22.8
嘉義縣,民雄鄉,菁埔村,687,171,516,12,699,1708,40.93,10.01
嘉義縣,民雄鄉,中和村,365,157,208,4,369,962,38.36,16.32
嘉義縣,民雄鄉,平和村,348,123,225,5,353,817,43.21,15.06
嘉義縣,民雄鄉,西昌村,345,102,243,4,349,821,42.51,12.42
嘉義縣,民雄鄉,豊收村,833,377,456,11,844,2163,39.02,17.43
嘉義縣,民雄鄉,三興村,597,260,337,11,608,1346,45.17,19.32
嘉義縣,民雄鄉,東興村,207,80,127,2,209,523,39.96,15.3
嘉義縣,民雄鄉,鎮北村,457,188,269,13,470,1154,40.73,16.29
嘉義縣,民雄鄉,興中村,669,253,416,4,673,1837,36.64,13.77
嘉義縣,民雄鄉,興南村,932,377,555,11,943,2740,34.42,13.76
嘉義縣,民雄鄉,福興村,853,306,547,5,858,1995,43.01,15.34
嘉義縣,民雄鄉,文隆村,994,433,561,11,1005,2450,41.02,17.67
嘉義縣,民雄鄉,山中村,1380,477,903,18,1398,3513,39.8,13.58
嘉義縣,民雄鄉,中央村,513,150,363,7,520,1281,40.59,11.71
嘉義縣,民雄鄉,北斗村,1933,787,1146,16,1949,5279,36.92,14.91
嘉義縣,民雄鄉,双福村,956,465,491,8,964,2449,39.36,18.99
嘉義縣,民雄鄉,大崎村,882,357,525,11,893,2361,37.82,15.12
嘉義縣,民雄鄉,秀林村,1029,341,688,16,1045,2602,40.16,13.11
嘉義縣,民雄鄉,松山村,590,225,365,6,596,1690,35.27,13.31
嘉義縣,民雄鄉,金興村,1136,477,659,9,1145,2956,38.73,16.14
嘉義縣,民雄鄉,福樂村,2568,1064,1504,21,2589,6649,38.94,16.0
嘉義縣,溪口鄉,溪東村,513,193,320,5,518,1277,40.56,15.11
嘉義縣,溪口鄉,溪西村,291,100,191,4,295,653,45.18,15.31
嘉義縣,溪口鄉,溪北村,232,79,153,4,236,636,37.11,12.42
嘉義縣,溪口鄉,游東村,396,92,304,3,399,952,41.91,9.66
嘉義縣,溪口鄉,游西村,260,54,206,3,263,656,40.09,8.23
嘉義縣,溪口鄉,柴林村,279,80,199,5,284,758,37.47,10.55
嘉義縣,溪口鄉,林腳村,260,62,198,4,264,803,32.88,7.72
嘉義縣,溪口鄉,美南村,361,91,270,12,373,1113,33.51,8.18
嘉義縣,溪口鄉,美北村,330,97,233,5,335,971,34.5,9.99
嘉義縣,溪口鄉,本厝村,365,121,244,8,373,921,40.5,13.14
嘉義縣,溪口鄉,柳溝村,498,164,334,9,507,1264,40.11,12.97
嘉義縣,溪口鄉,疊溪村,394,123,271,4,398,1013,39.29,12.14
嘉義縣,溪口鄉,妙崙村,243,78,165,2,245,680,36.03,11.47
嘉義縣,溪口鄉,坪頂村,359,112,247,3,362,878,41.23,12.76
嘉義縣,新港鄉,宮前村,985,417,568,7,992,2204,45.01,18.92
嘉義縣,新港鄉,宮後村,652,223,429,8,660,1541,42.83,14.47
嘉義縣,新港鄉,大興村,585,202,383,6,591,1424,41.5,14.19
嘉義縣,新港鄉,福德村,634,245,389,8,642,1618,39.68,15.14
嘉義縣,新港鄉,古民村,531,110,421,6,537,1375,39.05,8.0
嘉義縣,新港鄉,中庄村,644,181,463,9,653,1582,41.28,11.44
嘉義縣,新港鄉,大潭村,629,171,458,9,638,1618,39.43,10.57
嘉義縣,新港鄉,西庄村,380,144,236,4,384,931,41.25,15.47
嘉義縣,新港鄉,埤子村,214,52,162,3,217,549,39.53,9.47
嘉義縣,新港鄉,南崙村,357,55,302,10,367,886,41.42,6.21
嘉義縣,新港鄉,北崙村,165,29,136,7,172,465,36.99,6.24
嘉義縣,新港鄉,海瀛村,194,61,133,3,197,486,40.53,12.55
嘉義縣,新港鄉,月眉村,748,195,553,15,763,1627,46.9,11.99
嘉義縣,新港鄉,月潭村,584,147,437,9,593,1538,38.56,9.56
嘉義縣,新港鄉,溪北村,511,129,382,3,514,1308,39.3,9.86
嘉義縣,新港鄉,三間村,554,222,332,7,561,1492,37.6,14.88
嘉義縣,新港鄉,中洋村,406,148,258,5,411,1023,40.18,14.47
嘉義縣,新港鄉,菜公村,371,126,245,6,377,947,39.81,13.31
嘉義縣,新港鄉,安和村,357,83,274,5,362,985,36.75,8.43
嘉義縣,新港鄉,潭大村,425,117,308,8,433,1118,38.73,10.47
嘉義縣,新港鄉,南港村,382,118,264,3,385,1017,37.86,11.6
嘉義縣,新港鄉,板頭村,209,56,153,0,209,548,38.14,10.22
嘉義縣,新港鄉,共和村,327,94,233,3,330,838,39.38,11.22
嘉義縣,六腳鄉,蒜頭村,437,175,262,3,440,1127,39.04,15.53
嘉義縣,六腳鄉,蒜東村,271,102,169,5,276,788,35.03,12.94
嘉義縣,六腳鄉,蒜南村,322,89,233,3,325,829,39.2,10.74
嘉義縣,六腳鄉,工廠村,99,63,36,1,100,211,47.39,29.86
嘉義縣,六腳鄉,灣南村,424,139,285,6,430,1153,37.29,12.06
嘉義縣,六腳鄉,灣北村,365,163,202,8,373,1165,32.02,13.99
嘉義縣,六腳鄉,雙涵村,325,84,241,10,335,861,38.91,9.76
嘉義縣,六腳鄉,塗師村,241,62,179,10,251,615,40.81,10.08
嘉義縣,六腳鄉,三義村,259,64,195,6,265,725,36.55,8.83
嘉義縣,六腳鄉,港美村,264,41,223,6,270,677,39.88,6.06
嘉義縣,六腳鄉,豐美村,397,105,292,2,399,996,40.06,10.54
嘉義縣,六腳鄉,六斗村,307,104,203,5,312,905,34.48,11.49
嘉義縣,六腳鄉,崙陽村,359,105,254,3,362,1019,35.53,10.3
嘉義縣,六腳鄉,蘇厝村,485,136,349,5,490,1433,34.19,9.49
嘉義縣,六腳鄉,竹本村,202,62,140,2,204,594,34.34,10.44
嘉義縣,六腳鄉,永賢村,146,29,117,4,150,467,32.12,6.21
嘉義縣,六腳鄉,魚寮村,213,63,150,2,215,611,35.19,10.31
嘉義縣,六腳鄉,潭墘村,292,97,195,2,294,838,35.08,11.58
嘉義縣,六腳鄉,正義村,593,161,432,9,602,1392,43.25,11.57
嘉義縣,六腳鄉,溪厝村,216,67,149,5,221,578,38.24,11.59
嘉義縣,六腳鄉,六腳村,268,118,150,3,271,734,36.92,16.08
嘉義縣,六腳鄉,六南村,170,59,111,4,174,521,33.4,11.32
嘉義縣,六腳鄉,崩山村,236,71,165,3,239,627,38.12,11.32
嘉義縣,六腳鄉,古林村,261,53,208,5,266,659,40.36,8.04
嘉義縣,六腳鄉,更寮村,194,63,131,1,195,563,34.64,11.19
嘉義縣,東石鄉,東石村,670,200,470,12,682,1898,35.93,10.54
嘉義縣,東石鄉,猿樹村,300,105,195,6,306,922,33.19,11.39
嘉義縣,東石鄉,型厝村,417,152,265,6,423,1320,32.05,11.52
嘉義縣,東石鄉,塭港村,544,235,309,4,548,1622,33.79,14.49
嘉義縣,東石鄉,三家村,325,122,203,8,333,1120,29.73,10.89
嘉義縣,東石鄉,永屯村,209,81,128,3,212,701,30.24,11.55
嘉義縣,東石鄉,海埔村,138,55,83,6,144,388,37.11,14.18
嘉義縣,東石鄉,龍港村,294,166,128,9,303,839,36.11,19.79
嘉義縣,東石鄉,副瀨村,317,106,211,7,324,857,37.81,12.37
嘉義縣,東石鄉,下揖村,254,74,180,6,260,714,36.41,10.36
嘉義縣,東石鄉,頂揖村,143,56,87,1,144,368,39.13,15.22
嘉義縣,東石鄉,溪下村,258,102,156,6,264,957,27.59,10.66
嘉義縣,東石鄉,港墘村,469,167,302,9,478,1185,40.34,14.09
嘉義縣,東石鄉,蔦松村,269,102,167,10,279,821,33.98,12.42
嘉義縣,東石鄉,圍潭村,218,78,140,3,221,650,34.0,12.0
嘉義縣,東石鄉,洲仔村,241,77,164,11,252,795,31.7,9.69
嘉義縣,東石鄉,東崙村,231,93,138,4,235,670,35.07,13.88
嘉義縣,東石鄉,西崙村,410,140,270,7,417,1074,38.83,13.04
嘉義縣,東石鄉,塭仔村,329,69,260,6,335,893,37.51,7.73
嘉義縣,東石鄉,網寮村,373,158,215,3,376,1167,32.22,13.54
嘉義縣,東石鄉,掌潭村,325,125,200,2,327,757,43.2,16.51
嘉義縣,東石鄉,港口村,86,33,53,0,86,284,30.28,11.62
嘉義縣,東石鄉,鰲鼓村,409,142,267,11,420,1233,34.06,11.52
嘉義縣,義竹鄉,岸腳村,258,89,169,8,266,663,40.12,13.42
嘉義縣,義竹鄉,義竹村,602,208,394,12,614,1416,43.36,14.69
嘉義縣,義竹鄉,六桂村,452,205,247,9,461,1125,40.98,18.22
嘉義縣,義竹鄉,仁里村,354,153,201,4,358,829,43.18,18.46
嘉義縣,義竹鄉,傳芳村,282,107,175,5,287,749,38.32,14.29
嘉義縣,義竹鄉,頭竹村,466,152,314,9,475,1195,39.75,12.72
嘉義縣,義竹鄉,五厝村,148,57,91,1,149,368,40.49,15.49
嘉義縣,義竹鄉,中平村,172,79,93,5,177,412,42.96,19.17
嘉義縣,義竹鄉,埤前村,320,128,192,9,329,721,45.63,17.75
嘉義縣,義竹鄉,平溪村,173,55,118,1,174,422,41.23,13.03
嘉義縣,義竹鄉,後鎮村,185,86,99,3,188,417,45.08,20.62
嘉義縣,義竹鄉,北華村,248,94,154,4,252,591,42.64,15.91
嘉義縣,義竹鄉,新店村,479,177,302,6,485,1447,33.52,12.23
嘉義縣,義竹鄉,東過村,241,90,151,4,245,826,29.66,10.9
嘉義縣,義竹鄉,西過村,263,67,196,2,265,777,34.11,8.62
嘉義縣,義竹鄉,官和村,292,61,231,5,297,796,37.31,7.66
嘉義縣,義竹鄉,官順村,147,50,97,3,150,422,35.55,11.85
嘉義縣,義竹鄉,新富村,179,89,90,11,190,520,36.54,17.12
嘉義縣,義竹鄉,東光村,294,94,200,1,295,724,40.75,12.98
嘉義縣,義竹鄉,東榮村,149,47,102,3,152,363,41.87,12.95
嘉義縣,義竹鄉,龍蛟村,199,77,122,2,201,554,36.28,13.9
嘉義縣,義竹鄉,溪洲村,294,82,212,5,299,636,47.01,12.89
嘉義縣,鹿草鄉,後寮村,179,48,131,1,180,512,35.16,9.38
嘉義縣,鹿草鄉,鹿東村,219,60,159,1,220,540,40.74,11.11
嘉義縣,鹿草鄉,鹿草村,463,162,301,3,466,1289,36.15,12.57
嘉義縣,鹿草鄉,西井村,476,193,283,8,484,1319,36.69,14.63
嘉義縣,鹿草鄉,豊稠村,179,79,100,1,180,736,24.46,10.73
嘉義縣,鹿草鄉,重寮村,394,108,286,5,399,1002,39.82,10.78
嘉義縣,鹿草鄉,施家村,156,41,115,5,161,427,37.7,9.6
嘉義縣,鹿草鄉,下潭村,327,74,253,6,333,799,41.68,9.26
嘉義縣,鹿草鄉,光潭村,383,102,281,4,387,982,39.41,10.39
嘉義縣,鹿草鄉,碧潭村,329,137,192,6,335,937,35.75,14.62
嘉義縣,鹿草鄉,松竹村,294,113,181,6,300,927,32.36,12.19
嘉義縣,鹿草鄉,竹山村,342,79,263,8,350,895,39.11,8.83
嘉義縣,鹿草鄉,後堀村,437,141,296,6,443,1126,39.34,12.52
嘉義縣,鹿草鄉,三角村,578,176,402,7,585,1379,42.42,12.76
嘉義縣,鹿草鄉,下麻村,276,113,163,4,280,599,46.74,18.86
嘉義縣,水上鄉,水上村,1623,698,925,19,1642,4025,40.8,17.34
嘉義縣,水上鄉,水頭村,1054,466,588,7,1061,2466,43.03,18.9
嘉義縣,水上鄉,大堀村,776,238,538,9,785,1615,48.61,14.74
嘉義縣,水上鄉,大崙村,786,271,515,8,794,2073,38.3,13.07
嘉義縣,水上鄉,塗溝村,343,103,240,5,348,782,44.5,13.17
嘉義縣,水上鄉,粗溪村,605,261,344,12,617,1540,40.06,16.95
嘉義縣,水上鄉,下寮村,745,315,430,9,754,1867,40.39,16.87
嘉義縣,水上鄉,三和村,677,315,362,8,685,1779,38.5,17.71
嘉義縣,水上鄉,回歸村,182,82,100,2,184,427,43.09,19.2
嘉義縣,水上鄉,三鎮村,241,138,103,4,245,614,39.9,22.48
嘉義縣,水上鄉,靖和村,212,94,118,2,214,384,55.73,24.48
嘉義縣,水上鄉,南和村,521,181,340,2,523,1345,38.88,13.46
嘉義縣,水上鄉,龍德村,833,256,577,10,843,1915,44.02,13.37
嘉義縣,水上鄉,溪洲村,423,142,281,9,432,1028,42.02,13.81
嘉義縣,水上鄉,柳林村,718,278,440,8,726,2028,35.8,13.71
嘉義縣,水上鄉,柳鄉村,798,261,537,7,805,1983,40.6,13.16
嘉義縣,水上鄉,柳新村,686,326,360,6,692,1782,38.83,18.29
嘉義縣,水上鄉,寬士村,1648,622,1026,20,1668,4357,38.28,14.28
嘉義縣,水上鄉,民生村,1206,506,700,15,1221,2967,41.15,17.05
嘉義縣,水上鄉,忠和村,708,300,408,11,719,1853,38.8,16.19
嘉義縣,水上鄉,中庄村,648,253,395,2,650,1779,36.54,14.22
嘉義縣,水上鄉,南鄉村,337,127,210,2,339,910,37.25,13.96
嘉義縣,水上鄉,三界村,377,129,248,8,385,971,39.65,13.29
嘉義縣,水上鄉,國姓村,425,130,295,6,431,1239,34.79,10.49
嘉義縣,水上鄉,內溪村,430,159,271,6,436,1179,36.98,13.49
嘉義縣,水上鄉,義興村,308,115,193,2,310,792,39.14,14.52
嘉義縣,中埔鄉,中埔村,615,231,384,6,621,1790,34.69,12.91
嘉義縣,中埔鄉,塩舘村,373,155,218,2,375,935,40.11,16.58
嘉義縣,中埔鄉,龍門村,322,138,184,4,326,787,41.42,17.53
嘉義縣,中埔鄉,裕民村,342,89,253,4,346,862,40.14,10.32
嘉義縣,中埔鄉,金蘭村,462,186,276,6,468,1500,31.2,12.4
嘉義縣,中埔鄉,富收村,1056,417,639,14,1070,2900,36.9,14.38
嘉義縣,中埔鄉,和睦村,1238,479,759,11,1249,3322,37.6,14.42
嘉義縣,中埔鄉,和美村,2662,1128,1534,20,2682,7020,38.21,16.07
嘉義縣,中埔鄉,和興村,2025,781,1244,27,2052,5652,36.31,13.82
嘉義縣,中埔鄉,隆興村,646,263,383,5,651,1825,35.67,14.41
嘉義縣,中埔鄉,義仁村,515,163,352,5,520,1490,34.9,10.94
嘉義縣,中埔鄉,社口村,712,277,435,11,723,2097,34.48,13.21
嘉義縣,中埔鄉,灣潭村,321,116,205,2,323,1020,31.67,11.37
嘉義縣,中埔鄉,石硦村,413,161,252,7,420,1122,37.43,14.35
嘉義縣,中埔鄉,頂埔村,344,107,237,4,348,932,37.34,11.48
嘉義縣,中埔鄉,同仁村,658,216,442,7,665,1851,35.93,11.67
嘉義縣,中埔鄉,瑞豐村,225,96,129,2,227,723,31.4,13.28
嘉義縣,中埔鄉,沄水村,340,118,222,5,345,966,35.71,12.22
嘉義縣,中埔鄉,三層村,196,55,141,1,197,634,31.07,8.68
嘉義縣,中埔鄉,深坑村,257,101,156,5,262,714,36.69,14.15
嘉義縣,中埔鄉,東興村,154,64,90,2,156,356,43.82,17.98
嘉義縣,中埔鄉,中崙村,104,51,53,2,106,291,36.43,17.53
嘉義縣,竹崎鄉,竹崎村,960,386,574,11,971,2455,39.55,15.72
嘉義縣,竹崎鄉,和平村,728,265,463,9,737,2167,34.01,12.23
嘉義縣,竹崎鄉,坑頭村,233,93,140,3,236,750,31.47,12.4
嘉義縣,竹崎鄉,沙坑村,305,81,224,9,314,813,38.62,9.96
嘉義縣,竹崎鄉,獅埜村,502,165,337,8,510,1212,42.08,13.61
嘉義縣,竹崎鄉,義和村,293,114,179,6,299,603,49.59,18.91
嘉義縣,竹崎鄉,義仁村,307,103,204,3,310,1025,30.24,10.05
嘉義縣,竹崎鄉,灣橋村,1986,885,1101,21,2007,5214,38.49,16.97
嘉義縣,竹崎鄉,鹿滿村,548,206,342,5,553,1401,39.47,14.7
嘉義縣,竹崎鄉,紫雲村,466,193,273,9,475,1362,34.88,14.17
嘉義縣,竹崎鄉,內埔村,620,223,397,10,630,1562,40.33,14.28
嘉義縣,竹崎鄉,昇平村,485,167,318,5,490,1738,28.19,9.61
嘉義縣,竹崎鄉,白杞村,176,73,103,4,180,611,29.46,11.95
嘉義縣,竹崎鄉,桃源村,307,116,191,5,312,998,31.26,11.62
嘉義縣,竹崎鄉,塘興村,298,139,159,3,301,851,35.37,16.33
嘉義縣,竹崎鄉,義隆村,217,83,134,1,218,624,34.94,13.3
嘉義縣,竹崎鄉,龍山村,609,184,425,7,616,1756,35.08,10.48
嘉義縣,竹崎鄉,文峯村,219,85,134,5,224,626,35.78,13.58
嘉義縣,竹崎鄉,金獅村,156,57,99,1,157,416,37.74,13.7
嘉義縣,竹崎鄉,復金村,632,220,412,10,642,1845,34.8,11.92
嘉義縣,竹崎鄉,緞繻村,267,119,148,6,273,903,30.23,13.18
嘉義縣,竹崎鄉,仁壽村,66,16,50,0,66,238,27.73,6.72
嘉義縣,竹崎鄉,中和村,242,89,153,0,242,766,31.59,11.62
嘉義縣,竹崎鄉,光華村,206,104,102,4,210,681,30.84,15.27
嘉義縣,梅山鄉,梅東村,801,305,496,15,816,2182,37.4,13.98
嘉義縣,梅山鄉,梅南村,353,177,176,3,356,869,40.97,20.37
嘉義縣,梅山鄉,過山村,193,73,120,3,196,540,36.3,13.52
嘉義縣,梅山鄉,梅北村,1544,630,914,20,1564,4337,36.06,14.53
嘉義縣,梅山鄉,圳南村,146,56,90,3,149,393,37.91,14.25
嘉義縣,梅山鄉,永興村,181,80,101,2,183,500,36.6,16.0
嘉義縣,梅山鄉,半天村,107,33,74,3,110,355,30.99,9.3
嘉義縣,梅山鄉,圳北村,180,73,107,5,185,579,31.95,12.61
嘉義縣,梅山鄉,大南村,555,207,348,8,563,1618,34.8,12.79
嘉義縣,梅山鄉,双溪村,207,76,131,3,210,548,38.32,13.87
嘉義縣,梅山鄉,安靖村,222,91,131,4,226,814,27.76,11.18
嘉義縣,梅山鄉,太平村,139,64,75,1,140,488,28.69,13.11
嘉義縣,梅山鄉,碧湖村,84,41,43,0,84,275,30.55,14.91
嘉義縣,梅山鄉,太興村,153,90,63,0,153,414,36.96,21.74
嘉義縣,梅山鄉,瑞峯村,207,103,104,6,213,703,30.3,14.65
嘉義縣,梅山鄉,瑞里村,182,110,72,2,184,610,30.16,18.03
嘉義縣,梅山鄉,太和村,236,91,145,6,242,929,26.05,9.8
嘉義縣,梅山鄉,龍眼村,124,28,96,2,126,400,31.5,7.0
嘉義縣,番路鄉,江西村,440,230,210,4,444,1143,38.85,20.12
嘉義縣,番路鄉,內甕村,168,71,97,1,169,440,38.41,16.14
嘉義縣,番路鄉,新福村,408,167,241,5,413,1282,32.22,13.03
嘉義縣,番路鄉,下坑村,670,296,374,5,675,1748,38.62,16.93
嘉義縣,番路鄉,番路村,297,125,172,2,299,835,35.81,14.97
嘉義縣,番路鄉,民和村,313,138,175,1,314,849,36.98,16.25
嘉義縣,番路鄉,觸口村,408,172,236,5,413,1220,33.85,14.1
嘉義縣,番路鄉,大湖村,153,54,99,7,160,596,26.85,9.06
嘉義縣,番路鄉,公田村,249,106,143,2,251,956,26.26,11.09
嘉義縣,番路鄉,公興村,146,59,87,2,148,498,29.72,11.85
嘉義縣,番路鄉,草山村,98,66,32,1,99,364,27.2,18.13
嘉義縣,大埔鄉,大埔村,353,139,214,4,357,1448,24.65,9.6
嘉義縣,大埔鄉,和平村,171,59,112,3,174,650,26.77,9.08
嘉義縣,大埔鄉,永樂村,117,64,53,1,118,420,28.1,15.24
嘉義縣,大埔鄉,茄苳村,183,78,105,5,188,923,20.37,8.45
嘉義縣,大埔鄉,西興村,174,88,86,3,177,567,31.22,15.52
嘉義縣,阿里山鄉,中山村,111,61,50,1,112,367,30.52,16.62
嘉義縣,阿里山鄉,中正村,65,43,22,0,65,184,35.33,23.37
嘉義縣,阿里山鄉,香林村,42,28,14,0,42,142,29.58,19.72
嘉義縣,阿里山鄉,十字村,80,46,34,3,83,316,26.27,14.56
嘉義縣,阿里山鄉,來吉村,129,97,32,1,130,292,44.52,33.22
嘉義縣,阿里山鄉,豐山村,82,47,35,1,83,303,27.39,15.51
嘉義縣,阿里山鄉,達邦村,248,194,54,3,251,819,30.65,23.69
嘉義縣,阿里山鄉,樂野村,299,185,114,8,307,939,32.69,19.7
嘉義縣,阿里山鄉,里佳村,86,67,19,0,86,244,35.25,27.46
嘉義縣,阿里山鄉,山美村,129,101,28,2,131,472,27.75,21.4
嘉義縣,阿里山鄉,新美村,92,65,27,2,94,289,32.53,22.49
嘉義縣,阿里山鄉,茶山村,82,36,46,0,82,254,32.28,14.17
屏東縣,屏東市,維新里,1142,435,707,9,1151,2604,44.2,16.71
屏東縣,屏東市,橋南里,600,275,325,3,603,1528,39.46,18.0
屏東縣,屏東市,橋北里,397,171,226,3,400,843,47.45,20.28
屏東縣,屏東市,長春里,824,379,445,4,828,1836,45.1,20.64
屏東縣,屏東市,豐榮里,1207,533,674,9,1216,2467,49.29,21.61
屏東縣,屏東市,豐源里,1639,823,816,15,1654,3454,47.89,23.83
屏東縣,屏東市,豐田里,1720,802,918,6,1726,3905,44.2,20.54
屏東縣,屏東市,大連里,4206,2252,1954,31,4237,9028,46.93,24.94
屏東縣,屏東市,湖西里,674,204,470,6,680,1482,45.88,13.77
屏東縣,屏東市,湖南里,439,124,315,1,440,1032,42.64,12.02
屏東縣,屏東市,歸心里,471,118,353,9,480,1115,43.05,10.58
屏東縣,屏東市,瑞光里,3123,1540,1583,31,3154,7115,44.33,21.64
屏東縣,屏東市,新生里,2270,949,1321,19,2289,5421,42.22,17.51
屏東縣,屏東市,頂宅里,239,73,166,2,241,510,47.25,14.31
屏東縣,屏東市,厚生里,1240,425,815,10,1250,2821,44.31,15.07
屏東縣,屏東市,擇仁里,358,127,231,4,362,796,45.48,15.95
屏東縣,屏東市,建國里,405,192,213,8,413,900,45.89,21.33
屏東縣,屏東市,一心里,557,298,259,4,561,1173,47.83,25.4
屏東縣,屏東市,萬年里,297,99,198,4,301,678,44.4,14.6
屏東縣,屏東市,義勇里,557,331,226,7,564,1104,51.09,29.98
屏東縣,屏東市,光華里,273,106,167,4,277,655,42.29,16.18
屏東縣,屏東市,永安里,2911,1235,1676,20,2931,6960,42.11,17.74
屏東縣,屏東市,新興里,985,353,632,11,996,2467,40.37,14.31
屏東縣,屏東市,公館里,670,207,463,9,679,1488,45.63,13.91
屏東縣,屏東市,龍華里,925,315,610,14,939,2203,42.62,14.3
屏東縣,屏東市,玉成里,620,144,476,7,627,1481,42.34,9.72
屏東縣,屏東市,頂柳里,466,133,333,3,469,1083,43.31,12.28
屏東縣,屏東市,大湖里,711,257,454,8,719,1791,40.15,14.35
屏東縣,屏東市,安鎮里,840,291,549,13,853,1995,42.76,14.59
屏東縣,屏東市,永光里,449,179,270,5,454,1004,45.22,17.83
屏東縣,屏東市,大洲里,521,133,388,9,530,1166,45.45,11.41
屏東縣,屏東市,大武里,3416,1566,1850,32,3448,8068,42.74,19.41
屏東縣,屏東市,前進里,1216,435,781,8,1224,2872,42.62,15.15
屏東縣,屏東市,清溪里,1677,775,902,12,1689,4077,41.43,19.01
屏東縣,屏東市,長安里,837,305,532,8,845,1956,43.2,15.59
屏東縣,屏東市,斯文里,756,377,379,7,763,1637,46.61,23.03
屏東縣,屏東市,華山里,2003,1041,962,17,2020,4657,43.38,22.35
屏東縣,屏東市,興樂里,343,180,163,0,343,730,46.99,24.66
屏東縣,屏東市,明正里,264,135,129,1,265,652,40.64,20.71
屏東縣,屏東市,太平里,302,132,170,3,305,626,48.72,21.09
屏東縣,屏東市,中正里,1967,1033,934,20,1987,4603,43.17,22.44
屏東縣,屏東市,勝利里,2027,1103,924,14,2041,5471,37.31,20.16
屏東縣,屏東市,永城里,765,367,398,18,783,1912,40.95,19.19
屏東縣,屏東市,溝美里,989,457,532,9,998,2231,44.73,20.48
屏東縣,屏東市,北勢里,1084,488,596,11,1095,2284,47.94,21.37
屏東縣,屏東市,北興里,2559,1344,1215,20,2579,6059,42.56,22.18
屏東縣,屏東市,仁愛里,1019,481,538,9,1028,2149,47.84,22.38
屏東縣,屏東市,廣興里,871,391,480,7,878,2058,42.66,19.0
屏東縣,屏東市,崇蘭里,5175,2954,2221,36,5211,12298,42.37,24.02
屏東縣,屏東市,空翔里,802,532,270,7,809,1655,48.88,32.15
屏東縣,屏東市,潭墘里,4539,2679,1860,36,4575,11543,39.63,23.21
屏東縣,屏東市,三山里,568,181,387,10,578,1324,43.66,13.67
屏東縣,屏東市,海豐里,372,111,261,3,375,849,44.17,13.07
屏東縣,屏東市,仁義里,424,136,288,14,438,1089,40.22,12.49
屏東縣,屏東市,和興里,423,126,297,5,428,941,45.48,13.39
屏東縣,屏東市,信和里,688,176,512,4,692,1560,44.36,11.28
屏東縣,屏東市,崇武里,1251,913,338,13,1264,2890,43.74,31.59
屏東縣,屏東市,武廟里、大同里、端正里,537,176,361,2,539,1053,51.19,16.71
屏東縣,屏東市,文明里、泰安里,290,149,141,6,296,675,43.85,22.07
屏東縣,屏東市,光榮里、民權里,631,269,362,3,634,1310,48.4,20.53
屏東縣,屏東市,大埔里、必信里,558,212,346,3,561,1240,45.24,17.1
屏東縣,屏東市,崇智里、崇禮里,306,102,204,1,307,654,46.94,15.6
屏東縣,屏東市,楠樹里、扶風里、慶春里,599,206,393,8,607,1166,52.06,17.67
屏東縣,屏東市,安樂里、平和里,488,197,291,1,489,1039,47.06,18.96
屏東縣,屏東市,金泉里、勝豐里,510,187,323,5,515,1018,50.59,18.37
屏東縣,屏東市,凌雲里、鵬程里,216,114,102,1,217,525,41.33,21.71
屏東縣,屏東市,永順里、永昌里,234,104,130,7,241,520,46.35,20.0
屏東縣,潮州鎮,潮州里,224,116,108,2,226,505,44.75,22.97
屏東縣,潮州鎮,同榮里,300,104,196,2,302,582,51.89,17.87
屏東縣,潮州鎮,新榮里,552,219,333,3,555,1227,45.23,17.85
屏東縣,潮州鎮,新生里,415,157,258,2,417,983,42.42,15.97
屏東縣,潮州鎮,光華里,1748,764,984,8,1756,4770,36.81,16.02
屏東縣,潮州鎮,彭城里,374,108,266,4,378,859,44.0,12.57
屏東縣,潮州鎮,三星里,2289,1028,1261,18,2307,5434,42.45,18.92
屏東縣,潮州鎮,三共里,2767,1243,1524,18,2785,6463,43.09,19.23
屏東縣,潮州鎮,三和里,881,388,493,5,886,2106,42.07,18.42
屏東縣,潮州鎮,五魁里,549,206,343,6,555,1387,40.01,14.85
屏東縣,潮州鎮,蓬萊里,929,337,592,3,932,2401,38.82,14.04
屏東縣,潮州鎮,八爺里,920,369,551,8,928,2381,38.98,15.5
屏東縣,潮州鎮,永春里,2663,1124,1539,23,2686,7120,37.72,15.79
屏東縣,潮州鎮,富春里,449,189,260,6,455,1172,38.82,16.13
屏東縣,潮州鎮,光春里,554,219,335,7,561,1413,39.7,15.5
屏東縣,潮州鎮,興美里,314,109,205,0,314,881,35.64,12.37
屏東縣,潮州鎮,檨子里,168,59,109,1,169,468,36.11,12.61
屏東縣,潮州鎮,九塊里,621,176,445,13,634,1633,38.82,10.78
屏東縣,潮州鎮,泗林里,693,255,438,9,702,1615,43.47,15.79
屏東縣,潮州鎮,四春里,686,212,474,9,695,1694,41.03,12.51
屏東縣,潮州鎮,崙東里,610,183,427,6,616,1535,40.13,11.92
屏東縣,東港鎮,新勝里,951,305,646,6,957,1975,48.46,15.44
屏東縣,東港鎮,東和里,240,95,145,3,243,631,38.51,15.06
屏東縣,東港鎮,朝安里,596,171,425,7,603,1575,38.29,10.86
屏東縣,東港鎮,八德里,332,114,218,1,333,734,45.37,15.53
屏東縣,東港鎮,東隆里,439,153,286,2,441,1192,37.0,12.84
屏東縣,東港鎮,豐漁里,240,79,161,2,242,559,43.29,14.13
屏東縣,東港鎮,盛漁里,491,122,369,4,495,1329,37.25,9.18
屏東縣,東港鎮,興漁里,705,192,513,5,710,1804,39.36,10.64
屏東縣,東港鎮,鎮海里,1046,255,791,6,1052,2840,37.04,8.98
屏東縣,東港鎮,嘉蓮里,663,182,481,5,668,1680,39.76,10.83
屏東縣,東港鎮,南平里,526,194,332,10,536,1562,34.31,12.42
屏東縣,東港鎮,船頭里,2103,732,1371,14,2117,5363,39.47,13.65
屏東縣,東港鎮,下廍里,788,170,618,16,804,1937,41.51,8.78
屏東縣,東港鎮,大潭里,595,180,415,5,600,1532,39.16,11.75
屏東縣,東港鎮,興東里,3484,1325,2159,23,3507,9392,37.34,14.11
屏東縣,東港鎮,興農里,549,193,356,5,554,1324,41.84,14.58
屏東縣,東港鎮,興和里,417,92,325,10,427,1049,40.71,8.77
屏東縣,東港鎮,共和里,286,200,86,4,290,664,43.67,30.12
屏東縣,東港鎮,頂新里、頂中里,379,133,246,3,382,852,44.84,15.61
屏東縣,東港鎮,興台里、中興里,488,204,284,4,492,1133,43.42,18.01
屏東縣,恆春鎮,城南里,296,156,140,1,297,896,33.15,17.41
屏東縣,恆春鎮,城北里,707,346,361,7,714,2205,32.38,15.69
屏東縣,恆春鎮,城西里,321,163,158,7,328,1109,29.58,14.7
屏東縣,恆春鎮,山腳里,1199,606,593,6,1205,4194,28.73,14.45
屏東縣,恆春鎮,網紗里,895,439,456,11,906,3117,29.07,14.08
屏東縣,恆春鎮,仁壽里,228,92,136,2,230,856,26.87,10.75
屏東縣,恆春鎮,茄湖里,169,58,111,4,173,504,34.33,11.51
屏東縣,恆春鎮,頭溝里,165,64,101,2,167,473,35.31,13.53
屏東縣,恆春鎮,四溝里,274,105,169,4,278,1021,27.23,10.28
屏東縣,恆春鎮,德和里,250,102,148,4,254,928,27.37,10.99
屏東縣,恆春鎮,龍水里,283,133,150,2,285,1079,26.41,12.33
屏東縣,恆春鎮,山海里,479,145,334,10,489,1560,31.35,9.29
屏東縣,恆春鎮,大光里,533,265,268,8,541,2199,24.6,12.05
屏東縣,恆春鎮,水泉里,319,108,211,5,324,1388,23.34,7.78
屏東縣,恆春鎮,南灣里,477,243,234,7,484,1686,28.71,14.41
屏東縣,恆春鎮,墾丁里,458,201,257,6,464,1205,38.51,16.68
屏東縣,恆春鎮,鵝鑾里,334,171,163,5,339,1082,31.33,15.8
屏東縣,萬丹鄉,萬安村,245,70,175,1,246,587,41.91,11.93
屏東縣,萬丹鄉,萬惠村,361,138,223,2,363,817,44.43,16.89
屏東縣,萬丹鄉,萬全村,1459,528,931,18,1477,3322,44.46,15.89
屏東縣,萬丹鄉,萬後村,241,84,157,0,241,711,33.9,11.81
屏東縣,萬丹鄉,萬生村,612,247,365,5,617,1403,43.98,17.61
屏東縣,萬丹鄉,寶厝村,857,345,512,10,867,2249,38.55,15.34
屏東縣,萬丹鄉,四維村,820,275,545,13,833,2047,40.69,13.43
屏東縣,萬丹鄉,竹林村,693,225,468,10,703,1671,42.07,13.46
屏東縣,萬丹鄉,廣安村,1019,338,681,8,1027,2276,45.12,14.85
屏東縣,萬丹鄉,田厝村,439,109,330,8,447,973,45.94,11.2
屏東縣,萬丹鄉,崙頂村,714,222,492,8,722,1835,39.35,12.1
屏東縣,萬丹鄉,厦北村,683,190,493,9,692,1593,43.44,11.93
屏東縣,萬丹鄉,厦南村,563,199,364,8,571,1407,40.58,14.14
屏東縣,萬丹鄉,上村村,364,100,264,4,368,822,44.77,12.17
屏東縣,萬丹鄉,加興村,542,121,421,5,547,1248,43.83,9.7
屏東縣,萬丹鄉,社口村,556,191,365,12,568,1471,38.61,12.98
屏東縣,萬丹鄉,磚寮村,421,138,283,3,424,943,44.96,14.63
屏東縣,萬丹鄉,社皮村,842,270,572,6,848,1968,43.09,13.72
屏東縣,萬丹鄉,社上村,708,216,492,13,721,1666,43.28,12.97
屏東縣,萬丹鄉,社中村,709,190,519,15,724,1692,42.79,11.23
屏東縣,萬丹鄉,水泉村,765,261,504,13,778,1694,45.93,15.41
屏東縣,萬丹鄉,新庄村,871,342,529,7,878,2075,42.31,16.48
屏東縣,萬丹鄉,香社村,623,213,410,7,630,1508,41.78,14.12
屏東縣,萬丹鄉,後村村,450,131,319,4,454,977,46.47,13.41
屏東縣,萬丹鄉,新鐘村,726,327,399,7,733,2019,36.31,16.2
屏東縣,萬丹鄉,灣內村,523,139,384,11,534,1343,39.76,10.35
屏東縣,萬丹鄉,興全村,471,160,311,10,481,1145,42.01,13.97
屏東縣,萬丹鄉,興安村,355,100,255,1,356,828,43.0,12.08
屏東縣,萬丹鄉,水仙村,232,103,129,3,235,546,43.04,18.86
屏東縣,萬丹鄉,甘棠村,130,48,82,4,134,394,34.01,12.18
屏東縣,長治鄉,進興村,1108,455,653,12,1120,2655,42.18,17.14
屏東縣,長治鄉,新潭村,1507,692,815,13,1520,3605,42.16,19.2
屏東縣,長治鄉,潭頭村,890,381,509,4,894,1921,46.54,19.83
屏東縣,長治鄉,香楊村,1164,501,663,12,1176,2628,44.75,19.06
屏東縣,長治鄉,長興村,477,211,266,2,479,1056,45.36,19.98
屏東縣,長治鄉,德成村,406,164,242,4,410,859,47.73,19.09
屏東縣,長治鄉,德協村,467,162,305,5,472,1045,45.17,15.5
屏東縣,長治鄉,復興村,665,244,421,9,674,1475,45.69,16.54
屏東縣,長治鄉,崙上村,701,294,407,4,705,1639,43.01,17.94
屏東縣,長治鄉,德榮村,523,161,362,6,529,1144,46.24,14.07
屏東縣,長治鄉,德和村,270,74,196,3,273,743,36.74,9.96
屏東縣,長治鄉,繁華村,920,230,690,10,930,2349,39.59,9.79
屏東縣,長治鄉,繁昌村,667,202,465,10,677,1719,39.38,11.75
屏東縣,長治鄉,繁榮村,483,156,327,7,490,1404,34.9,11.11
屏東縣,長治鄉,繁隆村,400,149,251,5,405,1127,35.94,13.22
屏東縣,長治鄉,榮華村,305,191,114,1,306,710,43.1,26.9
屏東縣,麟洛鄉,新田村,1003,325,678,10,1013,2127,47.63,15.28
屏東縣,麟洛鄉,麟頂村,436,156,280,3,439,925,47.46,16.86
屏東縣,麟洛鄉,麟蹄村,739,262,477,5,744,1484,50.13,17.65
屏東縣,麟洛鄉,麟趾村,1182,404,778,8,1190,2480,47.98,16.29
屏東縣,麟洛鄉,田中村,557,175,382,3,560,1156,48.44,15.14
屏東縣,麟洛鄉,田心村,417,157,260,4,421,846,49.76,18.56
屏東縣,麟洛鄉,田道村,349,120,229,2,351,671,52.31,17.88
屏東縣,九如鄉,九清村,598,160,438,5,603,1438,41.93,11.13
屏東縣,九如鄉,九塊村,585,149,436,7,592,1353,43.75,11.01
屏東縣,九如鄉,九明村,789,202,587,10,799,1675,47.7,12.06
屏東縣,九如鄉,玉水村,508,136,372,12,520,1222,42.55,11.13
屏東縣,九如鄉,大坵村,472,144,328,6,478,1155,41.39,12.47
屏東縣,九如鄉,三塊村,607,144,463,7,614,1563,39.28,9.21
屏東縣,九如鄉,後庄村,797,169,628,23,820,1747,46.94,9.67
屏東縣,九如鄉,耆老村,539,137,402,6,545,1257,43.36,10.9
屏東縣,九如鄉,洽興村,614,180,434,11,625,1454,42.98,12.38
屏東縣,九如鄉,東寧村,2007,639,1368,14,2021,4613,43.81,13.85
屏東縣,九如鄉,玉泉村,708,237,471,8,716,1586,45.15,14.94
屏東縣,里港鄉,玉田村,1305,410,895,15,1320,3156,41.83,12.99
屏東縣,里港鄉,大平村,470,167,303,11,481,1106,43.49,15.1
屏東縣,里港鄉,永春村,341,97,244,3,344,840,40.95,11.55
屏東縣,里港鄉,春林村,579,186,393,3,582,1323,43.99,14.06
屏東縣,里港鄉,過江村,817,247,570,10,827,1992,41.52,12.4
屏東縣,里港鄉,鐵店村,597,183,414,6,603,1418,42.52,12.91
屏東縣,里港鄉,塔樓村,635,159,476,10,645,1522,42.38,10.45
屏東縣,里港鄉,潮厝村,595,155,440,6,601,1564,38.43,9.91
屏東縣,里港鄉,茄苳村,655,162,493,11,666,1502,44.34,10.79
屏東縣,里港鄉,載興村,984,230,754,18,1002,2297,43.62,10.01
屏東縣,里港鄉,土庫村,849,424,425,6,855,1980,43.18,21.41
屏東縣,里港鄉,三廍村,723,291,432,13,736,1815,40.55,16.03
屏東縣,里港鄉,中和村,348,123,225,5,353,956,36.92,12.87
屏東縣,里港鄉,瀰力村,255,57,198,8,263,514,51.17,11.09
屏東縣,鹽埔鄉,新圍村,1080,332,748,18,1098,3077,35.68,10.79
屏東縣,鹽埔鄉,高朗村,901,299,602,13,914,2767,33.03,10.81
屏東縣,鹽埔鄉,鹽北村,579,262,317,10,589,1800,32.72,14.56
屏東縣,鹽埔鄉,鹽中村,782,367,415,11,793,2311,34.31,15.88
屏東縣,鹽埔鄉,鹽南村,558,261,297,8,566,1683,33.63,15.51
屏東縣,鹽埔鄉,仕絨村,353,187,166,3,356,1022,34.83,18.3
屏東縣,鹽埔鄉,振興村,602,236,366,15,617,1803,34.22,13.09
屏東縣,鹽埔鄉,永隆村,215,60,155,1,216,537,40.22,11.17
屏東縣,鹽埔鄉,久愛村,343,144,199,8,351,908,38.66,15.86
屏東縣,鹽埔鄉,洛陽村,640,260,380,8,648,1606,40.35,16.19
屏東縣,鹽埔鄉,新二村,1246,546,700,13,1259,3450,36.49,15.83
屏東縣,鹽埔鄉,彭厝村,382,153,229,4,386,957,40.33,15.99
屏東縣,高樹鄉,高樹村,957,234,723,12,969,2093,46.3,11.18
屏東縣,高樹鄉,長榮村,537,106,431,8,545,1236,44.09,8.58
屏東縣,高樹鄉,東興村,329,64,265,3,332,707,46.96,9.05
屏東縣,高樹鄉,東振村,238,59,179,7,245,578,42.39,10.21
屏東縣,高樹鄉,源泉村,440,131,309,5,445,995,44.72,13.17
屏東縣,高樹鄉,建興村,435,93,342,13,448,1135,39.47,8.19
屏東縣,高樹鄉,大埔村,252,65,187,3,255,592,43.07,10.98
屏東縣,高樹鄉,菜寮村,307,53,254,8,315,727,43.33,7.29
屏東縣,高樹鄉,司馬村,211,69,142,6,217,618,35.11,11.17
屏東縣,高樹鄉,舊寮村,484,128,356,0,484,1183,40.91,10.82
屏東縣,高樹鄉,新豐村,508,140,368,6,514,1416,36.3,9.89
屏東縣,高樹鄉,泰山村,656,209,447,10,666,1828,36.43,11.43
屏東縣,高樹鄉,南華村,464,130,334,10,474,1231,38.51,10.56
屏東縣,高樹鄉,廣福村,437,119,318,7,444,1041,42.65,11.43
屏東縣,高樹鄉,廣興村,361,115,246,4,365,1085,33.64,10.6
屏東縣,高樹鄉,舊庄村,395,104,291,6,401,988,40.59,10.53
屏東縣,高樹鄉,田子村,413,120,293,6,419,1054,39.75,11.39
屏東縣,高樹鄉,鹽樹村,537,150,387,6,543,1172,46.33,12.8
屏東縣,高樹鄉,新南村,541,147,394,13,554,1483,37.36,9.91
屏東縣,萬巒鄉,萬巒村,501,144,357,11,512,1171,43.72,12.3
屏東縣,萬巒鄉,萬全村,311,106,205,3,314,715,43.92,14.83
屏東縣,萬巒鄉,萬和村,767,242,525,7,774,1663,46.54,14.55
屏東縣,萬巒鄉,鹿寮村,405,111,294,5,410,885,46.33,12.54
屏東縣,萬巒鄉,硫黃村,272,64,208,4,276,530,52.08,12.08
屏東縣,萬巒鄉,泗溝村,482,186,296,10,492,1083,45.43,17.17
屏東縣,萬巒鄉,五溝村,474,168,306,9,483,990,48.79,16.97
屏東縣,萬巒鄉,成德村,581,197,384,6,587,1392,42.17,14.15
屏東縣,萬巒鄉,萬金村,786,221,565,9,795,1976,40.23,11.18
屏東縣,萬巒鄉,赤山村,563,208,355,8,571,1657,34.46,12.55
屏東縣,萬巒鄉,佳佐村,622,163,459,6,628,1673,37.54,9.74
屏東縣,萬巒鄉,佳和村,529,200,329,3,532,1374,38.72,14.56
屏東縣,萬巒鄉,新厝村,479,113,366,7,486,1233,39.42,9.16
屏東縣,萬巒鄉,新置村,427,150,277,5,432,1162,37.18,12.91
屏東縣,內埔鄉,內埔村,1615,661,954,18,1633,3943,41.42,16.76
屏東縣,內埔鄉,內田村,1290,485,805,7,1297,3127,41.48,15.51
屏東縣,內埔鄉,興南村,597,212,385,7,604,1261,47.9,16.81
屏東縣,內埔鄉,義亭村,248,79,169,1,249,565,44.07,13.98
屏東縣,內埔鄉,美和村,924,357,567,10,934,2169,43.06,16.46
屏東縣,內埔鄉,和興村,1136,470,666,9,1145,2795,40.97,16.82
屏東縣,內埔鄉,東寧村,1878,716,1162,15,1893,4356,43.46,16.44
屏東縣,內埔鄉,豐田村,1252,468,784,8,1260,3045,41.38,15.37
屏東縣,內埔鄉,振豐村,766,268,498,3,769,1580,48.67,16.96
屏東縣,內埔鄉,富田村,828,234,594,7,835,1847,45.21,12.67
屏東縣,內埔鄉,竹圍村,795,255,540,10,805,1835,43.87,13.9
屏東縣,內埔鄉,東勢村,1194,356,838,12,1206,2856,42.23,12.46
屏東縣,內埔鄉,東片村,478,143,335,8,486,920,52.83,15.54
屏東縣,內埔鄉,上樹村,495,138,357,9,504,1079,46.71,12.79
屏東縣,內埔鄉,老埤村,752,235,517,8,760,2282,33.3,10.3
屏東縣,內埔鄉,中林村,551,131,420,8,559,1517,36.85,8.64
屏東縣,內埔鄉,龍泉村,881,408,473,16,897,2397,37.42,17.02
屏東縣,內埔鄉,龍潭村,763,427,336,14,777,2350,33.06,18.17
屏東縣,內埔鄉,建興村,360,145,215,7,367,782,46.93,18.54
屏東縣,內埔鄉,大新村,699,272,427,13,712,1726,41.25,15.76
屏東縣,內埔鄉,黎明村,842,257,585,12,854,2405,35.51,10.69
屏東縣,內埔鄉,隘寮村,409,148,261,10,419,1260,33.25,11.75
屏東縣,內埔鄉,水門村,331,147,184,4,335,795,42.14,18.49
屏東縣,竹田鄉,竹田村,660,247,413,5,665,1447,45.96,17.07
屏東縣,竹田鄉,竹南村,410,117,293,4,414,868,47.7,13.48
屏東縣,竹田鄉,糶糴村,331,119,212,7,338,676,50.0,17.6
屏東縣,竹田鄉,履豐村,277,90,187,4,281,577,48.7,15.6
屏東縣,竹田鄉,頭崙村,573,169,404,4,577,1289,44.76,13.11
屏東縣,竹田鄉,二崙村,475,163,312,2,477,969,49.23,16.82
屏東縣,竹田鄉,美崙村,316,117,199,2,318,621,51.21,18.84
屏東縣,竹田鄉,南勢村,252,71,181,2,254,459,55.34,15.47
屏東縣,竹田鄉,西勢村,1097,408,689,10,1107,2368,46.75,17.23
屏東縣,竹田鄉,福田村,238,76,162,3,241,477,50.52,15.93
屏東縣,竹田鄉,永豐村,353,126,227,0,353,881,40.07,14.3
屏東縣,竹田鄉,六巷村,359,122,237,7,366,796,45.98,15.33
屏東縣,竹田鄉,泗洲村,429,160,269,9,438,1099,39.85,14.56
屏東縣,竹田鄉,大湖村,501,155,346,3,504,1186,42.5,13.07
屏東縣,竹田鄉,鳳明村,458,192,266,8,466,1180,39.49,16.27
屏東縣,新埤鄉,新埤村,823,374,449,16,839,1959,42.83,19.09
屏東縣,新埤鄉,建功村,530,205,325,4,534,1030,51.84,19.9
屏東縣,新埤鄉,打鐵村,387,168,219,5,392,860,45.58,19.53
屏東縣,新埤鄉,南豐村,340,114,226,4,344,734,46.87,15.53
屏東縣,新埤鄉,萬隆村,567,235,332,5,572,1713,33.39,13.72
屏東縣,新埤鄉,箕湖村,361,127,234,7,368,1100,33.45,11.55
屏東縣,新埤鄉,餉潭村,367,101,266,5,372,1253,29.69,8.06
屏東縣,枋寮鄉,枋寮村,460,225,235,6,466,1196,38.96,18.81
屏東縣,枋寮鄉,新龍村,322,173,149,5,327,865,37.8,20.0
屏東縣,枋寮鄉,保生村,352,116,236,4,356,906,39.29,12.8
屏東縣,枋寮鄉,中寮村,250,78,172,3,253,573,44.15,13.61
屏東縣,枋寮鄉,安樂村,616,205,411,5,621,1578,39.35,12.99
屏東縣,枋寮鄉,隆山村,1529,467,1062,20,1549,4151,37.32,11.25
屏東縣,枋寮鄉,天時村,800,260,540,9,809,1866,43.35,13.93
屏東縣,枋寮鄉,地利村,650,245,405,4,654,1416,46.19,17.3
屏東縣,枋寮鄉,人和村,826,305,521,10,836,2027,41.24,15.05
屏東縣,枋寮鄉,內寮村,248,63,185,5,253,695,36.4,9.06
屏東縣,枋寮鄉,新開村,236,90,146,1,237,874,27.12,10.3
屏東縣,枋寮鄉,太源村,287,130,157,5,292,927,31.5,14.02
屏東縣,枋寮鄉,玉泉村,121,57,64,1,122,428,28.5,13.32
屏東縣,枋寮鄉,東海村,1017,432,585,13,1030,2680,38.43,16.12
屏東縣,枋寮鄉,大庄村,234,74,160,1,235,604,38.91,12.25
屏東縣,新園鄉,瓦磘村,668,163,505,10,678,1629,41.62,10.01
屏東縣,新園鄉,仙吉村,910,283,627,9,919,2479,37.07,11.42
屏東縣,新園鄉,田洋村,817,208,609,11,828,2135,38.78,9.74
屏東縣,新園鄉,港墘村,306,104,202,2,308,807,38.17,12.89
屏東縣,新園鄉,內庄村,359,119,240,4,363,820,44.27,14.51
屏東縣,新園鄉,新東村,825,312,513,14,839,2294,36.57,13.6
屏東縣,新園鄉,新園村,879,291,588,10,889,2190,40.59,13.29
屏東縣,新園鄉,烏龍村,498,146,352,11,509,1194,42.63,12.23
屏東縣,新園鄉,興龍村,903,241,662,5,908,2092,43.4,11.52
屏東縣,新園鄉,中洲村,645,121,524,7,652,1553,41.98,7.79
屏東縣,新園鄉,南龍村,565,135,430,11,576,1368,42.11,9.87
屏東縣,新園鄉,港西村,797,252,545,10,807,2061,39.16,12.23
屏東縣,新園鄉,五房村,1057,339,718,13,1070,2733,39.15,12.4
屏東縣,新園鄉,鹽埔村,1612,401,1211,20,1632,4335,37.65,9.25
屏東縣,新園鄉,共和村,776,162,614,12,788,2284,34.5,7.09
屏東縣,崁頂鄉,崁頂村,843,302,541,9,852,2220,38.38,13.6
屏東縣,崁頂鄉,園寮村,795,303,492,7,802,1996,40.18,15.18
屏東縣,崁頂鄉,圍內村,491,168,323,6,497,1200,41.42,14.0
屏東縣,崁頂鄉,力社村,505,149,356,8,513,1272,40.33,11.71
屏東縣,崁頂鄉,洲子村,369,119,250,4,373,1046,35.66,11.38
屏東縣,崁頂鄉,北勢村,602,188,414,13,615,1466,41.95,12.82
屏東縣,崁頂鄉,越溪村,355,119,236,3,358,905,39.56,13.15
屏東縣,崁頂鄉,港東村,722,191,531,7,729,1834,39.75,10.41
屏東縣,林邊鄉,林邊村,624,202,422,6,630,1392,45.26,14.51
屏東縣,林邊鄉,光林村,620,195,425,9,629,1509,41.68,12.92
屏東縣,林邊鄉,仁和村,691,219,472,9,700,1603,43.67,13.66
屏東縣,林邊鄉,中林村,322,124,198,4,326,690,47.25,17.97
屏東縣,林邊鄉,永樂村,1376,420,956,14,1390,3098,44.87,13.56
屏東縣,林邊鄉,水利村,646,244,402,8,654,1761,37.14,13.86
屏東縣,林邊鄉,崎峯村,430,146,284,8,438,1241,35.29,11.76
屏東縣,林邊鄉,田厝村,349,110,239,6,355,895,39.66,12.29
屏東縣,林邊鄉,竹林村,757,229,528,8,765,1885,40.58,12.15
屏東縣,林邊鄉,鎮安村,459,150,309,12,471,1086,43.37,13.81
屏東縣,南州鄉,溪洲村,689,237,452,6,695,1652,42.07,14.35
屏東縣,南州鄉,溪南村,397,147,250,2,399,908,43.94,16.19
屏東縣,南州鄉,仁里村,219,82,137,4,223,487,45.79,16.84
屏東縣,南州鄉,溪北村,309,181,128,2,311,673,46.21,26.89
屏東縣,南州鄉,七塊村,365,132,233,4,369,1011,36.5,13.06
屏東縣,南州鄉,萬華村,366,132,234,2,368,965,38.13,13.68
屏東縣,南州鄉,米崙村,456,175,281,4,460,1028,44.75,17.02
屏東縣,南州鄉,壽元村,423,74,349,8,431,1050,41.05,7.05
屏東縣,南州鄉,同安村,421,96,325,5,426,965,44.15,9.95
屏東縣,南州鄉,南安村,234,66,168,6,240,515,46.6,12.82
屏東縣,佳冬鄉,佳冬村,585,215,370,5,590,1467,40.22,14.66
屏東縣,佳冬鄉,六根村,544,189,355,4,548,1302,42.09,14.52
屏東縣,佳冬鄉,賴家村,341,96,245,4,345,733,47.07,13.1
屏東縣,佳冬鄉,萬建村,691,240,451,5,696,1793,38.82,13.39
屏東縣,佳冬鄉,石光村,796,210,586,13,809,1922,42.09,10.93
屏東縣,佳冬鄉,玉光村,792,198,594,14,806,2056,39.2,9.63
屏東縣,佳冬鄉,昌隆村,397,123,274,13,410,936,43.8,13.14
屏東縣,佳冬鄉,豐隆村,274,89,185,3,277,674,41.1,13.2
屏東縣,佳冬鄉,大同村,449,119,330,5,454,1138,39.89,10.46
屏東縣,佳冬鄉,羌園村,412,105,307,7,419,1061,39.49,9.9
屏東縣,佳冬鄉,燄溫村,358,122,236,2,360,1072,33.58,11.38
屏東縣,佳冬鄉,塭豐村,772,321,451,11,783,2355,33.25,13.63
屏東縣,琉球鄉,本福村,501,254,247,3,504,2066,24.39,12.29
屏東縣,琉球鄉,中福村,271,140,131,3,274,1247,21.97,11.23
屏東縣,琉球鄉,漁福村,223,158,65,3,226,975,23.18,16.21
屏東縣,琉球鄉,大福村,292,176,116,1,293,1617,18.12,10.88
屏東縣,琉球鄉,南福村,193,111,82,1,194,1117,17.37,9.94
屏東縣,琉球鄉,天福村,198,113,85,0,198,1101,17.98,10.26
屏東縣,琉球鄉,上福村,260,157,103,2,262,1622,16.15,9.68
屏東縣,琉球鄉,杉福村,171,90,81,2,173,850,20.35,10.59
屏東縣,車城鄉,福興村,489,199,290,3,492,1315,37.41,15.13
屏東縣,車城鄉,福安村,225,61,164,2,227,534,42.51,11.42
屏東縣,車城鄉,田中村,157,61,96,1,158,610,25.9,10.0
屏東縣,車城鄉,海口村,204,91,113,4,208,717,29.01,12.69
屏東縣,車城鄉,統埔村,111,48,63,0,111,370,30.0,12.97
屏東縣,車城鄉,溫泉村,269,112,157,4,273,837,32.62,13.38
屏東縣,車城鄉,保力村,352,156,196,8,360,1197,30.08,13.03
屏東縣,車城鄉,新街村,146,38,108,2,148,418,35.41,9.09
屏東縣,車城鄉,埔墘村,112,58,54,0,112,412,27.18,14.08
屏東縣,車城鄉,射寮村,150,73,77,4,154,481,32.02,15.18
屏東縣,車城鄉,後灣村,154,66,88,4,158,399,39.6,16.54
屏東縣,滿州鄉,滿州村,422,203,219,5,427,1429,29.88,14.21
屏東縣,滿州鄉,里德村,119,56,63,1,120,392,30.61,14.29
屏東縣,滿州鄉,永靖村,371,171,200,3,374,1208,30.96,14.16
屏東縣,滿州鄉,港口村,392,129,263,3,395,1223,32.3,10.55
屏東縣,滿州鄉,响林村,148,47,101,0,148,526,28.14,8.94
屏東縣,滿州鄉,長樂村,267,143,124,5,272,1255,21.67,11.39
屏東縣,滿州鄉,九棚村,90,43,47,0,90,348,25.86,12.36
屏東縣,滿州鄉,港仔村,98,47,51,0,98,305,32.13,15.41
屏東縣,枋山鄉,枋山村,351,166,185,10,361,966,37.37,17.18
屏東縣,枋山鄉,加祿村,695,238,457,7,702,1872,37.5,12.71
屏東縣,枋山鄉,楓港村,292,74,218,2,294,962,30.56,7.69
屏東縣,枋山鄉,善餘村,249,76,173,2,251,837,29.99,9.08
屏東縣,三地門鄉,三地村,550,441,109,16,566,1460,38.77,30.21
屏東縣,三地門鄉,達來村,95,61,34,1,96,341,28.15,17.89
屏東縣,三地門鄉,德文村,86,56,30,2,88,566,15.55,9.89
屏東縣,三地門鄉,大社村,172,139,33,6,178,639,27.86,21.75
屏東縣,三地門鄉,賽嘉村,218,165,53,3,221,725,30.48,22.76
屏東縣,三地門鄉,口社村,190,136,54,3,193,550,35.09,24.73
屏東縣,三地門鄉,馬兒村,101,68,33,0,101,341,29.62,19.94
屏東縣,三地門鄉,安坡村,155,117,38,3,158,468,33.76,25.0
屏東縣,三地門鄉,青山村,200,172,28,4,204,694,29.39,24.78
屏東縣,三地門鄉,青葉村,167,136,31,1,168,617,27.23,22.04
屏東縣,霧臺鄉,霧台村,348,240,108,3,351,1089,32.23,22.04
屏東縣,霧臺鄉,阿禮村,106,93,13,1,107,297,36.03,31.31
屏東縣,霧臺鄉,吉露村,72,54,18,0,72,183,39.34,29.51
屏東縣,霧臺鄉,大武村,66,42,24,2,68,441,15.42,9.52
屏東縣,霧臺鄉,佳暮村,150,127,23,1,151,356,42.42,35.67
屏東縣,霧臺鄉,好茶村,184,117,67,3,187,476,39.29,24.58
屏東縣,瑪家鄉,瑪家村,161,123,38,1,162,443,36.57,27.77
屏東縣,瑪家鄉,北葉村,311,244,67,2,313,771,40.6,31.65
屏東縣,瑪家鄉,凉山村,282,227,55,1,283,1041,27.19,21.81
屏東縣,瑪家鄉,佳義村,307,213,94,3,310,887,34.95,24.01
屏東縣,瑪家鄉,排灣村,135,112,23,0,135,419,32.22,26.73
屏東縣,瑪家鄉,三和村,778,641,137,11,789,2049,38.51,31.28
屏東縣,泰武鄉,佳平村,325,272,53,2,327,844,38.74,32.23
屏東縣,泰武鄉,武潭村,336,266,70,7,343,950,36.11,28.0
屏東縣,泰武鄉,平和村,211,131,80,2,213,610,34.92,21.48
屏東縣,泰武鄉,佳興村,117,104,13,1,118,408,28.92,25.49
屏東縣,泰武鄉,泰武村,206,173,33,5,211,772,27.33,22.41
屏東縣,泰武鄉,萬安村,255,227,28,0,255,748,34.09,30.35
屏東縣,來義鄉,來義村,257,215,42,1,258,909,28.38,23.65
屏東縣,來義鄉,義林村,194,153,41,3,197,586,33.62,26.11
屏東縣,來義鄉,丹林村,262,228,34,0,262,709,36.95,32.16
屏東縣,來義鄉,古樓村,404,342,62,5,409,1112,36.78,30.76
屏東縣,來義鄉,文樂村,295,247,48,4,299,840,35.6,29.4
屏東縣,來義鄉,望嘉村,347,315,32,3,350,864,40.51,36.46
屏東縣,來義鄉,南和村,409,350,59,8,417,1197,34.84,29.24
屏東縣,春日鄉,春日村,191,152,39,2,193,923,20.91,16.47
屏東縣,春日鄉,古華村,187,139,48,2,189,685,27.59,20.29
屏東縣,春日鄉,士文村,56,40,16,5,61,311,19.61,12.86
屏東縣,春日鄉,七佳村,281,226,55,6,287,940,30.53,24.04
屏東縣,春日鄉,歸崇村,168,126,42,9,177,647,27.36,19.47
屏東縣,春日鄉,力里村,126,93,33,6,132,469,28.14,19.83
屏東縣,獅子鄉,楓林村,222,187,35,4,226,702,32.19,26.64
屏東縣,獅子鄉,丹路村,203,176,27,4,207,759,27.27,23.19
屏東縣,獅子鄉,草埔村,213,183,30,4,217,626,34.66,29.23
屏東縣,獅子鄉,內文村,73,61,12,0,73,229,31.88,26.64
屏東縣,獅子鄉,竹坑村,97,77,20,1,98,293,33.45,26.28
屏東縣,獅子鄉,獅子村,147,122,25,0,147,490,30.0,24.9
屏東縣,獅子鄉,內獅村,221,186,35,4,225,624,36.06,29.81
屏東縣,獅子鄉,南世村,112,91,21,3,115,369,31.17,24.66
屏東縣,牡丹鄉,石門村,497,409,88,9,506,1579,32.05,25.9
屏東縣,牡丹鄉,牡丹村,220,192,28,9,229,645,35.5,29.77
屏東縣,牡丹鄉,東源村,148,123,25,2,150,435,34.48,28.28
屏東縣,牡丹鄉,旭海村,123,93,30,7,130,359,36.21,25.91
屏東縣,牡丹鄉,高士村,149,120,29,3,152,567,26.81,21.16
屏東縣,牡丹鄉,四林村,105,83,22,3,108,549,19.67,15.12
宜蘭縣,宜蘭市,神農里,1048,552,496,15,1063,2534,41.95,21.78
宜蘭縣,宜蘭市,民權里,596,317,279,5,601,1744,34.46,18.18
宜蘭縣,宜蘭市,進士里,920,456,464,11,931,2115,44.02,21.56
宜蘭縣,宜蘭市,南橋里,525,232,293,5,530,1269,41.77,18.28
宜蘭縣,宜蘭市,建業里,845,354,491,6,851,1962,43.37,18.04
宜蘭縣,宜蘭市,南津里,876,493,383,14,890,2131,41.76,23.13
宜蘭縣,宜蘭市,凱旋里,516,206,310,10,526,1298,40.52,15.87
宜蘭縣,宜蘭市,黎明里,719,311,408,6,725,1846,39.27,16.85
宜蘭縣,宜蘭市,東村里,844,392,452,8,852,2200,38.73,17.82
宜蘭縣,宜蘭市,延平里,1189,593,596,13,1202,3263,36.84,18.17
宜蘭縣,宜蘭市,七張里,532,198,334,8,540,1459,37.01,13.57
宜蘭縣,宜蘭市,慈安里,604,297,307,7,611,1801,33.93,16.49
宜蘭縣,宜蘭市,新民里,651,246,405,8,659,1464,45.01,16.8
宜蘭縣,宜蘭市,東門里,401,140,261,1,402,951,42.27,14.72
宜蘭縣,宜蘭市,小東里,636,270,366,5,641,1595,40.19,16.93
宜蘭縣,宜蘭市,菜園里,523,232,291,4,527,1334,39.51,17.39
宜蘭縣,宜蘭市,孝廉里,447,166,281,3,450,1122,40.11,14.8
宜蘭縣,宜蘭市,新生里,947,350,597,6,953,2678,35.59,13.07
宜蘭縣,宜蘭市,茭白里,764,330,434,11,775,2080,37.26,15.87
宜蘭縣,宜蘭市,北津里,823,304,519,12,835,2200,37.95,13.82
宜蘭縣,宜蘭市,梅洲里,1159,437,722,4,1163,3159,36.82,13.83
宜蘭縣,宜蘭市,北門里,484,182,302,8,492,1112,44.24,16.37
宜蘭縣,宜蘭市,中山里,346,150,196,4,350,902,38.8,16.63
宜蘭縣,宜蘭市,西門里,738,269,469,7,745,1736,42.91,15.5
宜蘭縣,宜蘭市,南門里,555,244,311,2,557,1330,41.88,18.35
宜蘭縣,宜蘭市,負郭里,1180,556,624,9,1189,2908,40.89,19.12
宜蘭縣,宜蘭市,民族里,938,492,446,10,948,2157,43.95,22.81
宜蘭縣,宜蘭市,建軍里,651,315,336,3,654,1576,41.5,19.99
宜蘭縣,宜蘭市,思源里,1762,964,798,14,1776,4247,41.82,22.7
宜蘭縣,宜蘭市,文化里,1229,629,600,7,1236,2966,41.67,21.21
宜蘭縣,宜蘭市,復興里,1082,583,499,7,1089,2613,41.68,22.31
宜蘭縣,宜蘭市,成功里,1151,558,593,9,1160,3044,38.11,18.33
宜蘭縣,宜蘭市,新東里,1175,595,580,8,1183,3099,38.17,19.2
宜蘭縣,宜蘭市,七結里,1096,591,505,6,1102,2533,43.51,23.33
宜蘭縣,宜蘭市,泰山里,657,348,309,3,660,1969,33.52,17.67
宜蘭縣,宜蘭市,大新里,305,138,167,2,307,770,39.87,17.92
宜蘭縣,宜蘭市,中興里,1015,478,537,6,1021,2844,35.9,16.81
宜蘭縣,宜蘭市,擺厘里,1232,571,661,7,1239,2875,43.1,19.86
宜蘭縣,羅東鎮,大新里,617,252,365,8,625,1532,40.8,16.45
宜蘭縣,羅東鎮,東安里,1295,517,778,11,1306,3501,37.3,14.77
宜蘭縣,羅東鎮,新群里,1051,358,693,8,1059,2687,39.41,13.32
宜蘭縣,羅東鎮,羅莊里,1190,509,681,7,1197,3002,39.87,16.96
宜蘭縣,羅東鎮,南昌里,872,385,487,8,880,2352,37.41,16.37
宜蘭縣,羅東鎮,南豪里,551,228,323,6,557,1294,43.04,17.62
宜蘭縣,羅東鎮,成功里,630,249,381,3,633,1501,42.17,16.59
宜蘭縣,羅東鎮,仁德里,486,207,279,4,490,1123,43.63,18.43
宜蘭縣,羅東鎮,漢民里,1418,598,820,13,1431,3579,39.98,16.71
宜蘭縣,羅東鎮,西安里,1086,449,637,6,1092,2799,39.01,16.04
宜蘭縣,羅東鎮,北成里,1085,443,642,17,1102,2795,39.43,15.85
宜蘭縣,羅東鎮,賢文里,1381,620,761,22,1403,3502,40.06,17.7
宜蘭縣,羅東鎮,公正里,1124,443,681,14,1138,2641,43.09,16.77
宜蘭縣,羅東鎮,集祥里,369,151,218,5,374,1099,34.03,13.74
宜蘭縣,羅東鎮,信義里,1222,513,709,14,1236,2919,42.34,17.57
宜蘭縣,羅東鎮,竹林里,1156,459,697,18,1174,2844,41.28,16.14
宜蘭縣,羅東鎮,仁愛里,1482,601,881,12,1494,3570,41.85,16.83
宜蘭縣,羅東鎮,樹林里,1551,695,856,16,1567,3337,46.96,20.83
宜蘭縣,羅東鎮,國華里,1768,766,1002,17,1785,4280,41.71,17.9
宜蘭縣,羅東鎮,維揚里,1238,522,716,11,1249,2960,42.2,17.64
宜蘭縣,羅東鎮,開明里,568,216,352,8,576,1355,42.51,15.94
宜蘭縣,羅東鎮,中山里,533,184,349,6,539,1343,40.13,13.7
宜蘭縣,羅東鎮,仁和里,380,144,236,5,385,978,39.37,14.72
宜蘭縣,蘇澳鎮,龍德里,1196,420,776,23,1219,3347,36.42,12.55
宜蘭縣,蘇澳鎮,頂寮里,378,125,253,7,385,1020,37.75,12.25
宜蘭縣,蘇澳鎮,永榮里,1381,509,872,12,1393,3753,37.12,13.56
宜蘭縣,蘇澳鎮,存仁里,347,114,233,5,352,861,40.88,13.24
宜蘭縣,蘇澳鎮,港邊里,496,187,309,10,506,1218,41.54,15.35
宜蘭縣,蘇澳鎮,隘丁里,1150,429,721,12,1162,3062,37.95,14.01
宜蘭縣,蘇澳鎮,新城里,571,213,358,14,585,1452,40.29,14.67
宜蘭縣,蘇澳鎮,聖湖里,793,408,385,10,803,2219,36.19,18.39
宜蘭縣,蘇澳鎮,蘇西里,888,380,508,6,894,2348,38.07,16.18
宜蘭縣,蘇澳鎮,蘇北里,378,200,178,5,383,953,40.19,20.99
宜蘭縣,蘇澳鎮,蘇南里,216,89,127,1,217,437,49.66,20.37
宜蘭縣,蘇澳鎮,蘇東里,166,81,85,1,167,499,33.47,16.23
宜蘭縣,蘇澳鎮,長安里,181,76,105,4,185,521,35.51,14.59
宜蘭縣,蘇澳鎮,永光里,184,101,83,1,185,431,42.92,23.43
宜蘭縣,蘇澳鎮,永春里,192,79,113,2,194,573,33.86,13.79
宜蘭縣,蘇澳鎮,永樂里,151,66,85,2,153,439,34.85,15.03
宜蘭縣,蘇澳鎮,南安里,330,143,187,4,334,909,36.74,15.73
宜蘭縣,蘇澳鎮,南正里,330,109,221,5,335,893,37.51,12.21
宜蘭縣,蘇澳鎮,南成里,329,120,209,8,337,1052,32.03,11.41
宜蘭縣,蘇澳鎮,南興里,426,189,237,12,438,1414,30.98,13.37
宜蘭縣,蘇澳鎮,南寧里,345,151,194,6,351,1011,34.72,14.94
宜蘭縣,蘇澳鎮,南建里,402,132,270,6,408,1165,35.02,11.33
宜蘭縣,蘇澳鎮,東澳里,87,44,43,4,91,330,27.58,13.33
宜蘭縣,蘇澳鎮,南強里,222,76,146,4,226,691,32.71,11.0
宜蘭縣,蘇澳鎮,朝陽里,211,62,149,5,216,584,36.99,10.62
宜蘭縣,蘇澳鎮,聖愛里,919,387,532,6,925,2734,33.83,14.16
宜蘭縣,頭城鎮,石城里,81,27,54,0,81,304,26.64,8.88
宜蘭縣,頭城鎮,大里里,191,93,98,5,196,676,28.99,13.76
宜蘭縣,頭城鎮,大溪里,262,94,168,5,267,874,30.55,10.76
宜蘭縣,頭城鎮,合興里,85,39,46,1,86,345,24.93,11.3
宜蘭縣,頭城鎮,更新里,355,155,200,7,362,1352,26.78,11.46
宜蘭縣,頭城鎮,外澳里,240,113,127,3,243,862,28.19,13.11
宜蘭縣,頭城鎮,港口里,216,80,136,1,217,678,32.01,11.8
宜蘭縣,頭城鎮,武營里,569,300,269,4,573,1576,36.36,19.04
宜蘭縣,頭城鎮,大坑里,477,222,255,5,482,1356,35.55,16.37
宜蘭縣,頭城鎮,城東里,305,156,149,2,307,710,43.24,21.97
宜蘭縣,頭城鎮,城北里,198,121,77,2,200,488,40.98,24.8
宜蘭縣,頭城鎮,城西里,195,104,91,0,195,533,36.59,19.51
宜蘭縣,頭城鎮,城南里,264,137,127,3,267,645,41.4,21.24
宜蘭縣,頭城鎮,竹安里,571,261,310,11,582,2076,28.03,12.57
宜蘭縣,頭城鎮,新建里,699,336,363,9,708,2044,34.64,16.44
宜蘭縣,頭城鎮,拔雅里,716,364,352,10,726,2076,34.97,17.53
宜蘭縣,頭城鎮,福成里,293,141,152,6,299,931,32.12,15.15
宜蘭縣,頭城鎮,金面里,590,303,287,8,598,1711,34.95,17.71
宜蘭縣,頭城鎮,金盈里,226,111,115,1,227,692,32.8,16.04
宜蘭縣,頭城鎮,頂埔里,488,227,261,5,493,1301,37.89,17.45
宜蘭縣,頭城鎮,下埔里,306,126,180,5,311,909,34.21,13.86
宜蘭縣,頭城鎮,中崙里,308,140,168,5,313,1008,31.05,13.89
宜蘭縣,頭城鎮,二城里,342,156,186,4,346,1090,31.74,14.31
宜蘭縣,頭城鎮,龜山里,227,101,126,3,230,705,32.62,14.33
宜蘭縣,礁溪鄉,白雲村,525,219,306,8,533,1601,33.29,13.68
宜蘭縣,礁溪鄉,玉石村,704,313,391,9,713,1954,36.49,16.02
宜蘭縣,礁溪鄉,德陽村,1485,765,720,22,1507,3987,37.8,19.19
宜蘭縣,礁溪鄉,大忠村,918,442,476,16,934,2517,37.11,17.56
宜蘭縣,礁溪鄉,大義村,228,99,129,3,231,620,37.26,15.97
宜蘭縣,礁溪鄉,六結村,576,275,301,6,582,1372,42.42,20.04
宜蘭縣,礁溪鄉,二龍村,447,147,300,1,448,1198,37.4,12.27
宜蘭縣,礁溪鄉,時潮村,518,151,367,12,530,1460,36.3,10.34
宜蘭縣,礁溪鄉,玉田村,832,263,569,6,838,2114,39.64,12.44
宜蘭縣,礁溪鄉,三民村,843,308,535,11,854,2406,35.49,12.8
宜蘭縣,礁溪鄉,林美村,343,115,228,3,346,1132,30.57,10.16
宜蘭縣,礁溪鄉,白鵝村,293,121,172,4,297,830,35.78,14.58
宜蘭縣,礁溪鄉,玉光村,420,153,267,6,426,1059,40.23,14.45
宜蘭縣,礁溪鄉,光武村,479,175,304,4,483,1359,35.54,12.88
宜蘭縣,礁溪鄉,吳沙村,1031,384,647,11,1042,2526,41.25,15.2
宜蘭縣,礁溪鄉,龍潭村,1222,407,815,14,1236,3316,37.27,12.27
宜蘭縣,礁溪鄉,匏崙村,327,142,185,3,330,921,35.83,15.42
宜蘭縣,礁溪鄉,二結村,180,37,143,1,181,422,42.89,8.77
宜蘭縣,壯圍鄉,吉祥村,978,389,589,8,986,2606,37.84,14.93
宜蘭縣,壯圍鄉,美福村,692,291,401,5,697,1928,36.15,15.09
宜蘭縣,壯圍鄉,新南村,364,128,236,7,371,931,39.85,13.75
宜蘭縣,壯圍鄉,東港村,281,86,195,2,283,979,28.91,8.78
宜蘭縣,壯圍鄉,復興村,518,165,353,7,525,1599,32.83,10.32
宜蘭縣,壯圍鄉,過嶺村,481,156,325,9,490,1492,32.84,10.46
宜蘭縣,壯圍鄉,永鎮村,304,97,207,4,308,792,38.89,12.25
宜蘭縣,壯圍鄉,忠孝村,874,319,555,12,886,2369,37.4,13.47
宜蘭縣,壯圍鄉,古亭村,587,219,368,8,595,1580,37.66,13.86
宜蘭縣,壯圍鄉,功勞村,499,169,330,7,506,1240,40.81,13.63
宜蘭縣,壯圍鄉,美城村,848,339,509,12,860,2246,38.29,15.09
宜蘭縣,壯圍鄉,新社村,378,136,242,10,388,1058,36.67,12.85
宜蘭縣,壯圍鄉,大福村,556,204,352,11,567,1756,32.29,11.62
宜蘭縣,壯圍鄉,古結村,421,154,267,1,422,1124,37.54,13.7
宜蘭縣,員山鄉,員山村,2137,934,1203,26,2163,5810,37.23,16.08
宜蘭縣,員山鄉,尚德村,754,385,369,12,766,2164,35.4,17.79
宜蘭縣,員山鄉,惠好村,671,236,435,8,679,1676,40.51,14.08
宜蘭縣,員山鄉,七賢村,555,253,302,2,557,1505,37.01,16.81
宜蘭縣,員山鄉,深溝村,773,303,470,5,778,1941,40.08,15.61
宜蘭縣,員山鄉,蓁巷村,437,132,305,10,447,1249,35.79,10.57
宜蘭縣,員山鄉,內城村,449,210,239,12,461,1436,32.1,14.62
宜蘭縣,員山鄉,中華村,227,71,156,3,230,608,37.83,11.68
宜蘭縣,員山鄉,永和村,653,244,409,8,661,1818,36.36,13.42
宜蘭縣,員山鄉,頭分村,469,196,273,10,479,1340,35.75,14.63
宜蘭縣,員山鄉,枕山村,872,251,621,3,875,2277,38.43,11.02
宜蘭縣,員山鄉,同樂村,884,288,596,14,898,2403,37.37,11.99
宜蘭縣,員山鄉,湖東村,306,117,189,3,309,888,34.8,13.18
宜蘭縣,員山鄉,逸仙村,341,109,232,4,345,926,37.26,11.77
宜蘭縣,員山鄉,湖北村,351,138,213,3,354,997,35.51,13.84
宜蘭縣,員山鄉,湖西村,443,142,301,10,453,1363,33.24,10.42
宜蘭縣,冬山鄉,武淵村,470,130,340,3,473,1262,37.48,10.3
宜蘭縣,冬山鄉,珍珠村,694,222,472,11,705,1625,43.38,13.66
宜蘭縣,冬山鄉,補城村,453,177,276,5,458,1136,40.32,15.58
宜蘭縣,冬山鄉,三奇村,321,114,207,1,322,894,36.02,12.75
宜蘭縣,冬山鄉,大興村,346,81,265,9,355,867,40.95,9.34
宜蘭縣,冬山鄉,東城村,542,182,360,8,550,1409,39.03,12.92
宜蘭縣,冬山鄉,香和村,1097,398,699,8,1105,2951,37.44,13.49
宜蘭縣,冬山鄉,南興村,1174,442,732,9,1183,2943,40.2,15.02
宜蘭縣,冬山鄉,冬山村,315,120,195,5,320,673,47.55,17.83
宜蘭縣,冬山鄉,安平村,281,65,216,3,284,709,40.06,9.17
宜蘭縣,冬山鄉,太和村,646,204,442,9,655,1498,43.72,13.62
宜蘭縣,冬山鄉,八寶村,358,116,242,3,361,870,41.49,13.33
宜蘭縣,冬山鄉,丸山村,544,155,389,5,549,1512,36.31,10.25
宜蘭縣,冬山鄉,中山村,207,61,146,1,208,474,43.88,12.87
宜蘭縣,冬山鄉,順安村,1829,637,1192,21,1850,4962,37.28,12.84
宜蘭縣,冬山鄉,永美村,1186,399,787,19,1205,3096,38.92,12.89
宜蘭縣,冬山鄉,群英村,1896,720,1176,27,1923,4619,41.63,15.59
宜蘭縣,冬山鄉,清溝村,1521,605,916,16,1537,3769,40.78,16.05
宜蘭縣,冬山鄉,鹿埔村,884,275,609,10,894,2557,34.96,10.75
宜蘭縣,冬山鄉,得安村,367,152,215,4,371,1080,34.35,14.07
宜蘭縣,冬山鄉,廣興村,927,324,603,10,937,2509,37.35,12.91
宜蘭縣,冬山鄉,廣安村,689,269,420,9,698,1680,41.55,16.01
宜蘭縣,冬山鄉,柯林村,749,275,474,5,754,1761,42.82,15.62
宜蘭縣,冬山鄉,大進村,311,91,220,2,313,780,40.13,11.67
宜蘭縣,五結鄉,三興村,801,258,543,9,810,2052,39.47,12.57
宜蘭縣,五結鄉,二結村,786,335,451,9,795,1872,42.47,17.9
宜蘭縣,五結鄉,鎮安村,1087,402,685,14,1101,2629,41.88,15.29
宜蘭縣,五結鄉,上四村,664,254,410,2,666,1563,42.61,16.25
宜蘭縣,五結鄉,中興村,501,175,326,3,504,1350,37.33,12.96
宜蘭縣,五結鄉,四結村,1110,466,644,10,1120,2551,43.9,18.27
宜蘭縣,五結鄉,福興村,738,265,473,8,746,1777,41.98,14.91
宜蘭縣,五結鄉,五結村,1347,527,820,11,1358,3725,36.46,14.15
宜蘭縣,五結鄉,大吉村,1439,572,867,9,1448,3727,38.85,15.35
宜蘭縣,五結鄉,協和村,1212,393,819,12,1224,3260,37.55,12.06
宜蘭縣,五結鄉,孝威村,638,186,452,5,643,1654,38.88,11.25
宜蘭縣,五結鄉,錦眾村,552,187,365,5,557,1417,39.31,13.2
宜蘭縣,五結鄉,利澤村,673,210,463,10,683,1951,35.01,10.76
宜蘭縣,五結鄉,成興村,1148,348,800,8,1156,3177,36.39,10.95
宜蘭縣,五結鄉,季新村,1000,329,671,6,1006,2761,36.44,11.92
宜蘭縣,三星鄉,員山村,83,41,42,0,83,207,40.1,19.81
宜蘭縣,三星鄉,天山村,148,62,86,2,150,498,30.12,12.45
宜蘭縣,三星鄉,天福村,235,79,156,4,239,712,33.57,11.1
宜蘭縣,三星鄉,雙賢村,244,75,169,4,248,553,44.85,13.56
宜蘭縣,三星鄉,人和村,157,71,86,2,159,448,35.49,15.85
宜蘭縣,三星鄉,義德村,408,186,222,0,408,1133,36.01,16.42
宜蘭縣,三星鄉,集慶村,426,177,249,8,434,1145,37.9,15.46
宜蘭縣,三星鄉,月眉村,306,130,176,4,310,870,35.63,14.94
宜蘭縣,三星鄉,拱照村,394,132,262,3,397,1358,29.23,9.72
宜蘭縣,三星鄉,大隱村,1536,563,973,15,1551,4328,35.84,13.01
宜蘭縣,三星鄉,行健村,331,99,232,6,337,890,37.87,11.12
宜蘭縣,三星鄉,萬德村,239,82,157,2,241,586,41.13,13.99
宜蘭縣,三星鄉,貴林村,188,80,108,4,192,525,36.57,15.24
宜蘭縣,三星鄉,萬富村,281,106,175,4,285,731,38.99,14.5
宜蘭縣,三星鄉,大義村,521,164,357,5,526,1266,41.55,12.95
宜蘭縣,三星鄉,尚武村,289,121,168,1,290,758,38.26,15.96
宜蘭縣,三星鄉,大洲村,748,240,508,6,754,1581,47.69,15.18
宜蘭縣,三星鄉,尾塹村,606,193,413,6,612,1458,41.98,13.24
宜蘭縣,大同鄉,寒溪村,288,252,36,2,290,923,31.42,27.3
宜蘭縣,大同鄉,崙埤村,187,172,15,2,189,629,30.05,27.34
宜蘭縣,大同鄉,松羅村,200,144,56,4,204,701,29.1,20.54
宜蘭縣,大同鄉,復興村,99,59,40,1,100,262,38.17,22.52
宜蘭縣,大同鄉,英士村,98,79,19,1,99,325,30.46,24.31
宜蘭縣,大同鄉,樂水村,111,99,12,2,113,392,28.83,25.26
宜蘭縣,大同鄉,太平村,18,12,6,0,18,54,33.33,22.22
宜蘭縣,大同鄉,四季村,185,159,26,3,188,763,24.64,20.84
宜蘭縣,大同鄉,南山村,125,92,33,3,128,659,19.42,13.96
宜蘭縣,大同鄉,茂安村,58,46,12,0,58,207,28.02,22.22
宜蘭縣,南澳鄉,南澳村,300,263,37,5,305,1156,26.38,22.75
宜蘭縣,南澳鄉,碧候村,236,209,27,3,239,955,25.03,21.88
宜蘭縣,南澳鄉,東岳村,152,135,17,1,153,435,35.17,31.03
宜蘭縣,南澳鄉,金岳村,85,81,4,3,88,406,21.67,19.95
宜蘭縣,南澳鄉,武塔村,129,108,21,4,133,430,30.93,25.12
宜蘭縣,南澳鄉,金洋村,125,105,20,2,127,475,26.74,22.11
宜蘭縣,南澳鄉,澳花村,231,210,21,5,236,707,33.38,29.7
花蓮縣,花蓮市,民立里,622,404,218,4,626,1592,39.32,25.38
花蓮縣,花蓮市,民運里,823,562,261,15,838,1985,42.22,28.31
花蓮縣,花蓮市,民族里,168,105,63,1,169,422,40.05,24.88
花蓮縣,花蓮市,主信里,273,157,116,2,275,664,41.42,23.64
花蓮縣,花蓮市,主睦里,206,120,86,0,206,558,36.92,21.51
花蓮縣,花蓮市,主和里,1092,688,404,13,1105,2927,37.75,23.51
花蓮縣,花蓮市,國威里,577,343,234,6,583,1769,32.96,19.39
花蓮縣,花蓮市,國風里,1250,808,442,11,1261,3186,39.58,25.36
花蓮縣,花蓮市,民德里,655,428,227,4,659,1486,44.35,28.8
花蓮縣,花蓮市,民意里,803,666,137,16,819,2020,40.54,32.97
花蓮縣,花蓮市,主義里,197,127,70,1,198,464,42.67,27.37
花蓮縣,花蓮市,主工里,227,131,96,1,228,492,46.34,26.63
花蓮縣,花蓮市,主農里,1329,857,472,14,1343,3477,38.63,24.65
花蓮縣,花蓮市,國治里,301,184,117,4,305,821,37.15,22.41
花蓮縣,花蓮市,國富里,1960,1310,650,17,1977,4822,41.0,27.17
花蓮縣,花蓮市,民政里,1536,1089,447,12,1548,3629,42.66,30.01
花蓮縣,花蓮市,民勤里,1255,890,365,14,1269,3092,41.04,28.78
花蓮縣,花蓮市,民生里,421,236,185,9,430,1077,39.93,21.91
花蓮縣,花蓮市,主商里,215,116,99,1,216,537,40.22,21.6
花蓮縣,花蓮市,主學里,717,460,257,6,723,1821,39.7,25.26
花蓮縣,花蓮市,國光里,464,313,151,7,471,1214,38.8,25.78
花蓮縣,花蓮市,國聯里,1020,627,393,7,1027,2759,37.22,22.73
花蓮縣,花蓮市,國強里,641,422,219,5,646,1757,36.77,24.02
花蓮縣,花蓮市,民心里,378,264,114,5,383,932,41.09,28.33
花蓮縣,花蓮市,民樂里,239,166,73,1,240,616,38.96,26.95
花蓮縣,花蓮市,民主里,209,154,55,0,209,549,38.07,28.05
花蓮縣,花蓮市,主勤里,332,204,128,3,335,763,43.91,26.74
花蓮縣,花蓮市,主力里,1042,644,398,13,1055,2643,39.92,24.37
花蓮縣,花蓮市,國安里,198,125,73,2,200,496,40.32,25.2
花蓮縣,花蓮市,國魂里,775,494,281,12,787,1849,42.56,26.72
花蓮縣,花蓮市,國慶里,402,222,180,6,408,1069,38.17,20.77
花蓮縣,花蓮市,民享里,1215,898,317,14,1229,3012,40.8,29.81
花蓮縣,花蓮市,民有里,222,131,91,0,222,584,38.01,22.43
花蓮縣,花蓮市,民權里,172,124,48,1,173,419,41.29,29.59
花蓮縣,花蓮市,主計里,303,193,110,2,305,817,37.33,23.62
花蓮縣,花蓮市,主權里,1975,1323,652,23,1998,5198,38.44,25.45
花蓮縣,花蓮市,國華里,869,554,315,6,875,2120,41.27,26.13
花蓮縣,花蓮市,國防里,317,195,122,0,317,816,38.85,23.9
花蓮縣,花蓮市,國福里,464,333,131,6,470,1480,31.76,22.5
花蓮縣,花蓮市,國裕里,1619,1119,500,9,1628,4171,39.03,26.83
花蓮縣,花蓮市,主安里,853,569,284,13,866,2412,35.9,23.59
花蓮縣,花蓮市,國盛里,1235,817,418,10,1245,3671,33.91,22.26
花蓮縣,花蓮市,國興里,1689,1189,500,10,1699,4204,40.41,28.28
花蓮縣,花蓮市,民孝里,1407,1036,371,15,1422,3438,41.36,30.13
花蓮縣,鳳林鎮,鳳仁里,435,310,125,9,444,1166,38.08,26.59
花蓮縣,鳳林鎮,鳳義里,263,207,56,3,266,631,42.16,32.81
花蓮縣,鳳林鎮,鳳禮里,261,176,85,2,263,575,45.74,30.61
花蓮縣,鳳林鎮,鳳智里,409,314,95,3,412,1075,38.33,29.21
花蓮縣,鳳林鎮,鳳信里,464,362,102,13,477,1332,35.81,27.18
花蓮縣,鳳林鎮,山興里,169,135,34,6,175,539,32.47,25.05
花蓮縣,鳳林鎮,大榮里,458,303,155,5,463,1250,37.04,24.24
花蓮縣,鳳林鎮,北林里,205,116,89,3,208,538,38.66,21.56
花蓮縣,鳳林鎮,南平里,209,134,75,2,211,524,40.27,25.57
花蓮縣,鳳林鎮,林榮里,338,237,101,4,342,793,43.13,29.89
花蓮縣,鳳林鎮,長橋里,318,217,101,10,328,959,34.2,22.63
花蓮縣,鳳林鎮,森榮里,44,39,5,0,44,97,45.36,40.21
花蓮縣,玉里鎮,中城里,1743,1192,551,18,1761,5047,34.89,23.62
花蓮縣,玉里鎮,啟模里,476,344,132,6,482,1587,30.37,21.68
花蓮縣,玉里鎮,永昌里,334,243,91,6,340,1191,28.55,20.4
花蓮縣,玉里鎮,泰昌里,338,255,83,1,339,1281,26.46,19.91
花蓮縣,玉里鎮,國武里,447,284,163,4,451,1150,39.22,24.7
花蓮縣,玉里鎮,源城里,313,224,89,5,318,1204,26.41,18.6
花蓮縣,玉里鎮,長良里,149,114,35,3,152,606,25.08,18.81
花蓮縣,玉里鎮,樂合里,280,220,60,7,287,963,29.8,22.85
花蓮縣,玉里鎮,東豐里,153,115,38,3,156,521,29.94,22.07
花蓮縣,玉里鎮,觀音里,400,305,95,10,410,1500,27.33,20.33
花蓮縣,玉里鎮,松浦里,304,233,71,12,316,1449,21.81,16.08
花蓮縣,玉里鎮,春日里,250,182,68,12,262,838,31.26,21.72
花蓮縣,玉里鎮,德武里,203,163,40,9,212,750,28.27,21.73
花蓮縣,玉里鎮,三民里,240,155,85,6,246,864,28.47,17.94
花蓮縣,玉里鎮,大禹里,282,211,71,3,285,1039,27.43,20.31
花蓮縣,新城鄉,新城村,499,308,191,12,511,1249,40.91,24.66
花蓮縣,新城鄉,順安村,308,141,167,10,318,901,35.29,15.65
花蓮縣,新城鄉,康樂村,803,560,243,15,818,2413,33.9,23.21
花蓮縣,新城鄉,北埔村,1442,1022,420,15,1457,4113,35.42,24.85
花蓮縣,新城鄉,佳林村,370,247,123,2,372,992,37.5,24.9
花蓮縣,新城鄉,嘉里村,1246,923,323,14,1260,3787,33.27,24.37
花蓮縣,新城鄉,嘉新村,391,308,83,7,398,1243,32.02,24.78
花蓮縣,新城鄉,大漢村,883,680,203,15,898,2511,35.76,27.08
花蓮縣,吉安鄉,北昌村,2909,1883,1026,25,2934,7104,41.3,26.51
花蓮縣,吉安鄉,勝安村,2012,1284,728,16,2028,4909,41.31,26.16
花蓮縣,吉安鄉,太昌村,1277,796,481,24,1301,3726,34.92,21.36
花蓮縣,吉安鄉,永安村,1639,1116,523,14,1653,4253,38.87,26.24
花蓮縣,吉安鄉,慶豐村,2605,1772,833,22,2627,6951,37.79,25.49
花蓮縣,吉安鄉,吉安村,2023,1387,636,19,2042,5283,38.65,26.25
花蓮縣,吉安鄉,福興村,1175,753,422,18,1193,2931,40.7,25.69
花蓮縣,吉安鄉,南華村,605,362,243,9,614,1568,39.16,23.09
花蓮縣,吉安鄉,干城村,414,321,93,5,419,1280,32.73,25.08
花蓮縣,吉安鄉,永興村,1008,744,264,10,1018,2922,34.84,25.46
花蓮縣,吉安鄉,稻香村,1214,845,369,16,1230,3170,38.8,26.66
花蓮縣,吉安鄉,南昌村,1470,1040,430,15,1485,4138,35.89,25.13
花蓮縣,吉安鄉,宜昌村,1515,1016,499,11,1526,3933,38.8,25.83
花蓮縣,吉安鄉,仁里村,2293,1599,694,20,2313,5995,38.58,26.67
花蓮縣,吉安鄉,東昌村,2012,1464,548,27,2039,5503,37.05,26.6
花蓮縣,吉安鄉,仁安村,734,478,256,9,743,2360,31.48,20.25
花蓮縣,吉安鄉,仁和村,1508,1020,488,14,1522,4520,33.67,22.57
花蓮縣,吉安鄉,光華村,756,593,163,11,767,1987,38.6,29.84
花蓮縣,壽豐鄉,樹湖村,137,92,45,2,139,352,39.49,26.14
花蓮縣,壽豐鄉,溪口村,385,255,130,6,391,1019,38.37,25.02
花蓮縣,壽豐鄉,豐山村,649,432,217,15,664,1879,35.34,22.99
花蓮縣,壽豐鄉,豐裡村,474,326,148,3,477,1317,36.22,24.75
花蓮縣,壽豐鄉,豐坪村,295,208,87,4,299,900,33.22,23.11
花蓮縣,壽豐鄉,共和村,317,223,94,2,319,729,43.76,30.59
花蓮縣,壽豐鄉,壽豐村,575,381,194,10,585,1627,35.96,23.42
花蓮縣,壽豐鄉,光榮村,284,240,44,4,288,772,37.31,31.09
花蓮縣,壽豐鄉,池南村,298,196,102,4,302,747,40.43,26.24
花蓮縣,壽豐鄉,平和村,528,313,215,12,540,1402,38.52,22.33
花蓮縣,壽豐鄉,志學村,933,572,361,8,941,2522,37.31,22.68
花蓮縣,壽豐鄉,米棧村,109,84,25,5,114,259,44.02,32.43
花蓮縣,壽豐鄉,月眉村,266,214,52,4,270,816,33.09,26.23
花蓮縣,壽豐鄉,水璉村,230,173,57,7,237,700,33.86,24.71
花蓮縣,壽豐鄉,鹽寮村,167,117,50,1,168,503,33.4,23.26
花蓮縣,光復鄉,大安村,321,216,105,0,321,809,39.68,26.7
花蓮縣,光復鄉,大華村,415,263,152,11,426,1258,33.86,20.91
花蓮縣,光復鄉,大平村,269,211,58,14,283,918,30.83,22.98
花蓮縣,光復鄉,大馬村,252,215,37,6,258,970,26.6,22.16
花蓮縣,光復鄉,大同村,352,260,92,5,357,1018,35.07,25.54
花蓮縣,光復鄉,大進村,179,132,47,1,180,435,41.38,30.34
花蓮縣,光復鄉,大全村,224,143,81,7,231,765,30.2,18.69
花蓮縣,光復鄉,大興村,159,129,30,1,160,454,35.24,28.41
花蓮縣,光復鄉,大富村,107,67,40,0,107,302,35.43,22.19
花蓮縣,光復鄉,大豐村,144,94,50,3,147,409,35.94,22.98
花蓮縣,光復鄉,東富村,294,255,39,6,300,990,30.3,25.76
花蓮縣,光復鄉,西富村,309,241,68,9,318,928,34.27,25.97
花蓮縣,光復鄉,南富村,255,187,68,8,263,820,32.07,22.8
花蓮縣,光復鄉,北富村,258,212,46,2,260,880,29.55,24.09
花蓮縣,豐濱鄉,豐濱村,405,313,92,15,420,1596,26.32,19.61
花蓮縣,豐濱鄉,新社村,157,120,37,11,168,614,27.36,19.54
花蓮縣,豐濱鄉,磯崎村,118,96,22,2,120,390,30.77,24.62
花蓮縣,豐濱鄉,港口村,227,165,62,8,235,721,32.59,22.88
花蓮縣,豐濱鄉,靜浦村,181,158,23,7,188,645,29.15,24.5
花蓮縣,瑞穗鄉,瑞穗村,630,442,188,5,635,1828,34.74,24.18
花蓮縣,瑞穗鄉,瑞美村,638,439,199,7,645,1800,35.83,24.39
花蓮縣,瑞穗鄉,瑞良村,192,125,67,4,196,520,37.69,24.04
花蓮縣,瑞穗鄉,瑞祥村,295,192,103,2,297,923,32.18,20.8
花蓮縣,瑞穗鄉,瑞北村,161,125,36,6,167,580,28.79,21.55
花蓮縣,瑞穗鄉,舞鶴村,301,212,89,5,306,941,32.52,22.53
花蓮縣,瑞穗鄉,鶴岡村,248,198,50,5,253,867,29.18,22.84
花蓮縣,瑞穗鄉,奇美村,73,62,11,3,76,332,22.89,18.67
花蓮縣,瑞穗鄉,富源村,205,151,54,3,208,740,28.11,20.41
花蓮縣,瑞穗鄉,富民村,219,187,32,10,229,825,27.76,22.67
花蓮縣,瑞穗鄉,富興村,197,117,80,9,206,579,35.58,20.21
花蓮縣,富里鄉,吳江村,126,96,30,3,129,471,27.39,20.38
花蓮縣,富里鄉,東里村,224,142,82,13,237,970,24.43,14.64
花蓮縣,富里鄉,萬寧村,174,142,32,4,178,613,29.04,23.16
花蓮縣,富里鄉,新興村,139,98,41,10,149,573,26.0,17.1
花蓮縣,富里鄉,竹田村,318,233,85,2,320,1040,30.77,22.4
花蓮縣,富里鄉,羅山村,129,94,35,2,131,428,30.61,21.96
花蓮縣,富里鄉,石牌村,230,171,59,9,239,864,27.66,19.79
花蓮縣,富里鄉,明里村,131,93,38,3,134,368,36.41,25.27
花蓮縣,富里鄉,富里村,397,246,151,9,406,1306,31.09,18.84
花蓮縣,富里鄉,永豐村,147,109,38,4,151,442,34.16,24.66
花蓮縣,富里鄉,豐南村,161,132,29,8,169,597,28.31,22.11
花蓮縣,富里鄉,富南村,133,84,49,5,138,491,28.11,17.11
花蓮縣,富里鄉,學田村,193,115,78,10,203,622,32.64,18.49
花蓮縣,秀林鄉,崇德村,382,321,61,2,384,1423,26.99,22.56
花蓮縣,秀林鄉,富世村,579,427,152,7,586,1842,31.81,23.18
花蓮縣,秀林鄉,秀林村,522,401,121,8,530,1790,29.61,22.4
花蓮縣,秀林鄉,水源村,386,325,61,5,391,1188,32.91,27.36
花蓮縣,秀林鄉,銅門村,397,341,56,9,406,1217,33.36,28.02
花蓮縣,秀林鄉,文蘭村,346,300,46,1,347,1126,30.82,26.64
花蓮縣,秀林鄉,景美村,503,383,120,6,509,1791,28.42,21.38
花蓮縣,秀林鄉,佳民村,354,314,40,5,359,1048,34.26,29.96
花蓮縣,秀林鄉,和平村,458,342,116,2,460,1541,29.85,22.19
花蓮縣,萬榮鄉,西林村,299,251,48,3,302,1044,28.93,24.04
花蓮縣,萬榮鄉,見晴村,121,112,9,0,121,515,23.5,21.75
花蓮縣,萬榮鄉,萬榮村,195,159,36,4,199,757,26.29,21.0
花蓮縣,萬榮鄉,明利村,182,159,23,2,184,639,28.79,24.88
花蓮縣,萬榮鄉,馬遠村,261,213,48,7,268,1075,24.93,19.81
花蓮縣,萬榮鄉,紅葉村,258,221,37,4,262,1050,24.95,21.05
花蓮縣,卓溪鄉,崙山村,141,127,14,1,142,523,27.15,24.28
花蓮縣,卓溪鄉,立山村,234,211,23,8,242,969,24.97,21.78
花蓮縣,卓溪鄉,太平村,237,214,23,6,243,691,35.17,30.97
花蓮縣,卓溪鄉,卓溪村,191,171,20,3,194,721,26.91,23.72
花蓮縣,卓溪鄉,卓清村,231,212,19,5,236,1017,23.21,20.85
花蓮縣,卓溪鄉,古風村,288,252,36,5,293,897,32.66,28.09
臺東縣,臺東市,富岡里,449,314,135,12,461,1446,31.88,21.72
臺東縣,臺東市,富豐里,252,163,89,9,261,865,30.17,18.84
臺東縣,臺東市,岩灣里,759,515,244,8,767,2210,34.71,23.3
臺東縣,臺東市,南王里,892,610,282,6,898,2796,32.12,21.82
臺東縣,臺東市,卑南里,1240,721,519,5,1245,2822,44.12,25.55
臺東縣,臺東市,南榮里,894,614,280,11,905,2707,33.43,22.68
臺東縣,臺東市,新生里,2326,1531,795,14,2340,6528,35.85,23.45
臺東縣,臺東市,民生里,1276,740,536,19,1295,3035,42.67,24.38
臺東縣,臺東市,寶桑里,298,176,122,5,303,826,36.68,21.31
臺東縣,臺東市,馬蘭里,951,657,294,4,955,2489,38.37,26.4
臺東縣,臺東市,中心里,1199,782,417,11,1210,3004,40.28,26.03
臺東縣,臺東市,自強里,1587,996,591,12,1599,3981,40.17,25.02
臺東縣,臺東市,民族里,480,259,221,2,482,1313,36.71,19.73
臺東縣,臺東市,四維里,219,146,73,3,222,638,34.8,22.88
臺東縣,臺東市,中華里,564,320,244,4,568,1628,34.89,19.66
臺東縣,臺東市,強國里,217,131,86,2,219,620,35.32,21.13
臺東縣,臺東市,建國里,398,230,168,3,401,1215,33.0,18.93
臺東縣,臺東市,民權里,327,195,132,1,328,813,40.34,23.99
臺東縣,臺東市,仁愛里,269,137,132,0,269,683,39.39,20.06
臺東縣,臺東市,中正里,346,185,161,2,348,768,45.31,24.09
臺東縣,臺東市,大同里,272,170,102,3,275,727,37.83,23.38
臺東縣,臺東市,成功里,288,152,136,2,290,762,38.06,19.95
臺東縣,臺東市,文化里,244,141,103,1,245,941,26.04,14.98
臺東縣,臺東市,中山里,319,183,136,0,319,736,43.34,24.86
臺東縣,臺東市,復國里,178,113,65,0,178,575,30.96,19.65
臺東縣,臺東市,興國里,270,131,139,1,271,711,38.12,18.42
臺東縣,臺東市,復興里,135,76,59,1,136,400,34.0,19.0
臺東縣,臺東市,鐵花里,154,88,66,1,155,389,39.85,22.62
臺東縣,臺東市,新園里,540,353,187,13,553,1604,34.48,22.01
臺東縣,臺東市,豐田里,725,400,325,14,739,2224,33.23,17.99
臺東縣,臺東市,豐年里,960,622,338,13,973,3044,31.96,20.43
臺東縣,臺東市,光明里,975,651,324,5,980,2559,38.3,25.44
臺東縣,臺東市,豐樂里,487,311,176,5,492,1481,33.22,21.0
臺東縣,臺東市,永樂里,727,458,269,2,729,2117,34.44,21.63
臺東縣,臺東市,康樂里,392,246,146,8,400,1309,30.56,18.79
臺東縣,臺東市,東海里,1029,653,376,11,1040,2638,39.42,24.75
臺東縣,臺東市,新興里,327,193,134,3,330,940,35.11,20.53
臺東縣,臺東市,豐榮里,2896,1952,944,25,2921,8103,36.05,24.09
臺東縣,臺東市,豐谷里,1498,1013,485,10,1508,5024,30.02,20.16
臺東縣,臺東市,豐里里,745,421,324,9,754,2362,31.92,17.82
臺東縣,臺東市,豐原里,412,208,204,11,423,1214,34.84,17.13
臺東縣,臺東市,建和里,464,318,146,5,469,1392,33.69,22.84
臺東縣,臺東市,建興里,341,198,143,7,348,952,36.55,20.8
臺東縣,臺東市,建業里,386,234,152,2,388,1256,30.89,18.63
臺東縣,臺東市,知本里,460,295,165,5,465,1365,34.07,21.61
臺東縣,臺東市,建農里,570,423,147,15,585,1990,29.4,21.26
臺東縣,成功鎮,博愛里,202,167,35,10,212,596,35.57,28.02
臺東縣,成功鎮,忠孝里,230,157,73,6,236,935,25.24,16.79
臺東縣,成功鎮,三仙里,301,221,80,9,310,1337,23.19,16.53
臺東縣,成功鎮,三民里,659,496,163,15,674,2619,25.74,18.94
臺東縣,成功鎮,忠智里,577,407,170,7,584,1823,32.04,22.33
臺東縣,成功鎮,忠仁里,633,410,223,6,639,2079,30.74,19.72
臺東縣,成功鎮,和平里,189,139,50,4,193,725,26.62,19.17
臺東縣,成功鎮,信義里,502,405,97,8,510,1773,28.76,22.84
臺東縣,關山鎮,德高里,453,301,152,15,468,1682,27.82,17.9
臺東縣,關山鎮,豐泉里,379,257,122,3,382,1084,35.24,23.71
臺東縣,關山鎮,新福里,275,173,102,14,289,865,33.41,20.0
臺東縣,關山鎮,中福里,313,188,125,3,316,752,42.02,25.0
臺東縣,關山鎮,里壠里,529,389,140,2,531,1611,32.96,24.15
臺東縣,關山鎮,電光里,162,112,50,4,166,528,31.44,21.21
臺東縣,關山鎮,月眉里,188,106,82,6,194,689,28.16,15.38
臺東縣,卑南鄉,嘉豐村,134,84,50,6,140,486,28.81,17.28
臺東縣,卑南鄉,利吉村,154,121,33,1,155,449,34.52,26.95
臺東縣,卑南鄉,富山村,150,113,37,4,154,467,32.98,24.2
臺東縣,卑南鄉,富源村,119,55,64,1,120,333,36.04,16.52
臺東縣,卑南鄉,明峰村,337,192,145,9,346,1149,30.11,16.71
臺東縣,卑南鄉,初鹿村,361,228,133,9,370,1236,29.94,18.45
臺東縣,卑南鄉,美農村,356,169,187,9,365,1068,34.18,15.82
臺東縣,卑南鄉,賓朗村,729,413,316,7,736,2211,33.29,18.68
臺東縣,卑南鄉,泰安村,323,214,109,6,329,1122,29.32,19.07
臺東縣,卑南鄉,太平村,996,678,318,12,1008,3124,32.27,21.7
臺東縣,卑南鄉,利嘉村,396,303,93,12,408,1094,37.29,27.7
臺東縣,卑南鄉,東興村,389,328,61,11,400,1133,35.3,28.95
臺東縣,卑南鄉,溫泉村,346,140,206,4,350,1066,32.83,13.13
臺東縣,鹿野鄉,瑞和村,146,95,51,5,151,650,23.23,14.62
臺東縣,鹿野鄉,瑞豐村,319,128,191,4,323,871,37.08,14.7
臺東縣,鹿野鄉,瑞源村,223,135,88,4,227,835,27.19,16.17
臺東縣,鹿野鄉,永安村,427,277,150,0,427,1440,29.65,19.24
臺東縣,鹿野鄉,瑞隆村,218,147,71,3,221,858,25.76,17.13
臺東縣,鹿野鄉,鹿野村,318,231,87,9,327,1026,31.87,22.51
臺東縣,鹿野鄉,龍田村,371,180,191,2,373,1033,36.11,17.42
臺東縣,池上鄉,福文村,298,171,127,6,304,1091,27.86,15.67
臺東縣,池上鄉,慶豐村,212,138,74,8,220,660,33.33,20.91
臺東縣,池上鄉,大坡村,71,58,13,4,75,322,23.29,18.01
臺東縣,池上鄉,大埔村,253,173,80,5,258,773,33.38,22.38
臺東縣,池上鄉,福原村,663,386,277,7,670,1890,35.45,20.42
臺東縣,池上鄉,錦園村,95,41,54,3,98,337,29.08,12.17
臺東縣,池上鄉,新興村,252,148,104,6,258,832,31.01,17.79
臺東縣,池上鄉,萬安村,109,46,63,5,114,304,37.5,15.13
臺東縣,池上鄉,富興村,127,89,38,1,128,393,32.57,22.65
臺東縣,池上鄉,振興村,80,52,28,1,81,428,18.93,12.15
臺東縣,東河鄉,北源村,339,259,80,9,348,1544,22.54,16.77
臺東縣,東河鄉,泰源村,250,183,67,6,256,1127,22.72,16.24
臺東縣,東河鄉,東河村,265,203,62,3,268,951,28.18,21.35
臺東縣,東河鄉,尚德村,80,53,27,2,82,252,32.54,21.03
臺東縣,東河鄉,隆昌村,163,119,44,1,164,511,32.09,23.29
臺東縣,東河鄉,興昌村,292,178,114,4,296,886,33.41,20.09
臺東縣,東河鄉,都蘭村,670,443,227,16,686,2087,32.87,21.23
臺東縣,長濱鄉,樟原村,188,143,45,3,191,599,31.89,23.87
臺東縣,長濱鄉,三間村,329,278,51,15,344,1145,30.04,24.28
臺東縣,長濱鄉,忠勇村,126,83,43,3,129,519,24.86,15.99
臺東縣,長濱鄉,長濱村,581,403,178,13,594,1898,31.3,21.23
臺東縣,長濱鄉,竹湖村,256,165,91,8,264,853,30.95,19.34
臺東縣,長濱鄉,寧埔村,350,281,69,8,358,1154,31.02,24.35
臺東縣,太麻里鄉,美和村,378,167,211,6,384,1297,29.61,12.88
臺東縣,太麻里鄉,三和村,194,100,94,3,197,589,33.45,16.98
臺東縣,太麻里鄉,華源村,187,93,94,5,192,588,32.65,15.82
臺東縣,太麻里鄉,北里村,187,97,90,3,190,564,33.69,17.2
臺東縣,太麻里鄉,泰和村,442,274,168,11,453,1352,33.51,20.27
臺東縣,太麻里鄉,大王村,574,387,187,13,587,1720,34.13,22.5
臺東縣,太麻里鄉,香蘭村,265,175,90,7,272,811,33.54,21.58
臺東縣,太麻里鄉,金崙村,427,367,60,7,434,1705,25.45,21.52
臺東縣,太麻里鄉,多良村,269,238,31,10,279,900,31.0,26.44
臺東縣,大武鄉,大竹村,206,180,26,10,216,733,29.47,24.56
臺東縣,大武鄉,大鳥村,291,271,20,4,295,1061,27.8,25.54
臺東縣,大武鄉,大武村,344,251,93,7,351,1229,28.56,20.42
臺東縣,大武鄉,尚武村,338,172,166,5,343,1341,25.58,12.83
臺東縣,大武鄉,南興村,170,134,36,4,174,528,32.95,25.38
臺東縣,綠島鄉,公舘村,197,152,45,5,202,986,20.49,15.42
臺東縣,綠島鄉,中寮村,171,128,43,1,172,1038,16.57,12.33
臺東縣,綠島鄉,南寮村,256,189,67,4,260,1538,16.91,12.29
臺東縣,海端鄉,廣原村,196,171,25,1,197,730,26.99,23.42
臺東縣,海端鄉,霧鹿村,102,86,16,3,105,251,41.83,34.26
臺東縣,海端鄉,利稻村,68,41,27,0,68,261,26.05,15.71
臺東縣,海端鄉,海端村,224,190,34,4,228,957,23.82,19.85
臺東縣,海端鄉,崁頂村,164,135,29,1,165,575,28.7,23.48
臺東縣,海端鄉,加拿村,141,123,18,4,145,501,28.94,24.55
臺東縣,延平鄉,武陵村,180,157,23,8,188,593,31.7,26.48
臺東縣,延平鄉,永康村,112,101,11,1,113,318,35.53,31.76
臺東縣,延平鄉,紅葉村,131,116,15,7,138,421,32.78,27.55
臺東縣,延平鄉,鸞山村,145,132,13,3,148,577,25.65,22.88
臺東縣,延平鄉,桃源村,294,212,82,5,299,1003,29.81,21.14
臺東縣,金峰鄉,新興村,244,220,24,5,249,512,48.63,42.97
臺東縣,金峰鄉,正興村,256,237,19,3,259,603,42.95,39.3
臺東縣,金峰鄉,嘉蘭村,378,337,41,9,387,1235,31.34,27.29
臺東縣,金峰鄉,賓茂村,123,115,8,1,124,325,38.15,35.38
臺東縣,金峰鄉,歷坵村,126,114,12,1,127,329,38.6,34.65
臺東縣,達仁鄉,台坂村,231,197,34,4,235,589,39.9,33.45
臺東縣,達仁鄉,土坂村,274,236,38,4,278,851,32.67,27.73
臺東縣,達仁鄉,新化村,100,81,19,0,100,334,29.94,24.25
臺東縣,達仁鄉,安朔村,206,172,34,3,209,548,38.14,31.39
臺東縣,達仁鄉,森永村,143,118,25,0,143,359,39.83,32.87
臺東縣,達仁鄉,南田村,107,92,15,2,109,309,35.28,29.77
臺東縣,蘭嶼鄉,東清村,205,128,77,5,210,1293,16.24,9.9
臺東縣,蘭嶼鄉,朗島村,123,68,55,15,138,773,17.85,8.8
臺東縣,蘭嶼鄉,紅頭村,269,176,93,8,277,1256,22.05,14.01
臺東縣,蘭嶼鄉,椰油村,183,150,33,6,189,968,19.52,15.5
澎湖縣,馬公市,復興里,137,82,55,0,137,496,27.62,16.53
澎湖縣,馬公市,長安里,219,122,97,1,220,534,41.2,22.85
澎湖縣,馬公市,中央里,199,102,97,2,201,520,38.65,19.62
澎湖縣,馬公市,啟明里,334,153,181,2,336,872,38.53,17.55
澎湖縣,馬公市,重慶里,376,170,206,5,381,932,40.88,18.24
澎湖縣,馬公市,中興里,270,161,109,1,271,785,34.52,20.51
澎湖縣,馬公市,光復里,645,336,309,5,650,1903,34.16,17.66
澎湖縣,馬公市,光榮里,1482,993,489,15,1497,4135,36.2,24.01
澎湖縣,馬公市,光明里,407,257,150,9,416,1175,35.4,21.87
澎湖縣,馬公市,朝陽里,1661,954,707,8,1669,5179,32.23,18.42
澎湖縣,馬公市,陽明里,765,402,363,6,771,2417,31.9,16.63
澎湖縣,馬公市,重光里,510,276,234,6,516,1483,34.79,18.61
澎湖縣,馬公市,西衛里,1777,1052,725,17,1794,5825,30.8,18.06
澎湖縣,馬公市,西文里,997,574,423,5,1002,3202,31.29,17.93
澎湖縣,馬公市,東文里,986,552,434,10,996,3283,30.34,16.81
澎湖縣,馬公市,案山里,559,295,264,10,569,1855,30.67,15.9
澎湖縣,馬公市,光華里,222,137,85,2,224,979,22.88,13.99
澎湖縣,馬公市,前寮里,290,140,150,1,291,953,30.54,14.69
澎湖縣,馬公市,石泉里,879,531,348,4,883,2661,33.18,19.95
澎湖縣,馬公市,菜園里,145,77,68,0,145,439,33.03,17.54
澎湖縣,馬公市,東衛里,673,432,241,6,679,2134,31.82,20.24
澎湖縣,馬公市,安宅里,201,107,94,3,204,650,31.38,16.46
澎湖縣,馬公市,烏崁里,357,134,223,7,364,1060,34.34,12.64
澎湖縣,馬公市,興仁里,383,213,170,8,391,1240,31.53,17.18
澎湖縣,馬公市,鐵線里,228,84,144,2,230,677,33.97,12.41
澎湖縣,馬公市,山水里,513,197,316,8,521,1707,30.52,11.54
澎湖縣,馬公市,鎖港里,761,265,496,7,768,2539,30.25,10.44
澎湖縣,馬公市,五德里,97,56,41,0,97,470,20.64,11.91
澎湖縣,馬公市,井垵里,113,62,51,3,116,378,30.69,16.4
澎湖縣,馬公市,嵵裡里,305,186,119,4,309,1162,26.59,16.01
澎湖縣,馬公市,風櫃里,382,110,272,5,387,1368,28.29,8.04
澎湖縣,馬公市,虎井里,133,83,50,1,134,812,16.5,10.22
澎湖縣,馬公市,桶盤里,43,25,18,1,44,314,14.01,7.96
澎湖縣,湖西鄉,湖西村,367,201,166,3,370,1199,30.86,16.76
澎湖縣,湖西鄉,湖東村,98,52,46,1,99,358,27.65,14.53
澎湖縣,湖西鄉,青螺村,66,38,28,2,68,243,27.98,15.64
澎湖縣,湖西鄉,白坑村,86,43,43,5,91,297,30.64,14.48
澎湖縣,湖西鄉,南寮村,182,54,128,2,184,683,26.94,7.91
澎湖縣,湖西鄉,北寮村,87,50,37,0,87,327,26.61,15.29
澎湖縣,湖西鄉,紅羅村,217,78,139,5,222,748,29.68,10.43
澎湖縣,湖西鄉,西溪村,168,85,83,3,171,839,20.38,10.13
澎湖縣,湖西鄉,成功村,288,134,154,6,294,860,34.19,15.58
澎湖縣,湖西鄉,東石村,49,18,31,1,50,123,40.65,14.63
澎湖縣,湖西鄉,中西村,73,36,37,2,75,221,33.94,16.29
澎湖縣,湖西鄉,潭邊村,110,58,52,0,110,300,36.67,19.33
澎湖縣,湖西鄉,鼎灣村,132,78,54,2,134,641,20.9,12.17
澎湖縣,湖西鄉,許家村,101,52,49,1,102,389,26.22,13.37
澎湖縣,湖西鄉,沙港村,261,66,195,3,264,807,32.71,8.18
澎湖縣,湖西鄉,城北村,121,77,44,2,123,334,36.83,23.05
澎湖縣,湖西鄉,太武村,30,15,15,2,32,94,34.04,15.96
澎湖縣,湖西鄉,隘門村,284,142,142,3,287,911,31.5,15.59
澎湖縣,湖西鄉,林投村,294,104,190,9,303,1004,30.18,10.36
澎湖縣,湖西鄉,尖山村,195,70,125,0,195,670,29.1,10.45
澎湖縣,湖西鄉,龍門村,539,260,279,5,544,1760,30.91,14.77
澎湖縣,湖西鄉,菓葉村,229,70,159,4,233,762,30.58,9.19
澎湖縣,白沙鄉,中屯村,166,93,73,4,170,525,32.38,17.71
澎湖縣,白沙鄉,講美村,207,119,88,0,207,671,30.85,17.73
澎湖縣,白沙鄉,城前村,51,30,21,1,52,110,47.27,27.27
澎湖縣,白沙鄉,鎮海村,48,39,9,0,48,156,30.77,25.0
澎湖縣,白沙鄉,港子村,79,45,34,1,80,297,26.94,15.15
澎湖縣,白沙鄉,岐頭村,48,33,15,0,48,216,22.22,15.28
澎湖縣,白沙鄉,小赤村,63,35,28,0,63,168,37.5,20.83
澎湖縣,白沙鄉,赤崁村,465,250,215,5,470,1719,27.34,14.54
澎湖縣,白沙鄉,瓦硐村,90,50,40,0,90,307,29.32,16.29
澎湖縣,白沙鄉,後寮村,211,86,125,5,216,766,28.2,11.23
澎湖縣,白沙鄉,通梁村,203,89,114,3,206,798,25.81,11.15
澎湖縣,白沙鄉,吉貝村,261,56,205,4,265,1412,18.77,3.97
澎湖縣,白沙鄉,鳥嶼村,235,177,58,2,237,1110,21.35,15.95
澎湖縣,白沙鄉,員貝村,63,56,7,2,65,274,23.72,20.44
澎湖縣,白沙鄉,大倉村,50,17,33,1,51,269,18.96,6.32
澎湖縣,西嶼鄉,橫礁村,56,20,36,1,57,301,18.94,6.64
澎湖縣,西嶼鄉,合界村,98,36,62,2,100,415,24.1,8.67
澎湖縣,西嶼鄉,小門村,94,63,31,3,97,285,34.04,22.11
澎湖縣,西嶼鄉,竹灣村,218,87,131,4,222,817,27.17,10.65
澎湖縣,西嶼鄉,大池村,189,70,119,1,190,665,28.57,10.53
澎湖縣,西嶼鄉,二崁村,56,16,40,1,57,145,39.31,11.03
澎湖縣,西嶼鄉,池東村,182,79,103,2,184,642,28.66,12.31
澎湖縣,西嶼鄉,池西村,62,20,42,2,64,225,28.44,8.89
澎湖縣,西嶼鄉,赤馬村,141,48,93,1,142,580,24.48,8.28
澎湖縣,西嶼鄉,內垵村,325,103,222,2,327,1265,25.85,8.14
澎湖縣,西嶼鄉,外垵村,476,339,137,5,481,2058,23.37,16.47
澎湖縣,望安鄉,東安村,131,58,73,2,133,723,18.4,8.02
澎湖縣,望安鄉,西安村,92,59,33,0,92,436,21.1,13.53
澎湖縣,望安鄉,中社村,53,20,33,2,55,342,16.08,5.85
澎湖縣,望安鄉,水垵村,93,29,64,3,96,487,19.71,5.95
澎湖縣,望安鄉,將軍村,174,38,136,6,180,1425,12.63,2.67
澎湖縣,望安鄉,東坪村,18,7,11,0,18,527,3.42,1.33
澎湖縣,望安鄉,西坪村,8,4,4,0,8,220,3.64,1.82
澎湖縣,望安鄉,東吉村,38,17,21,0,38,296,12.84,5.74
澎湖縣,望安鄉,花嶼村,50,37,13,1,51,323,15.79,11.46
澎湖縣,七美鄉,東湖村,23,10,13,0,23,259,8.88,3.86
澎湖縣,七美鄉,西湖村,61,38,23,2,63,573,10.99,6.63
澎湖縣,七美鄉,中和村,69,38,31,3,72,643,11.2,5.91
澎湖縣,七美鄉,平和村,57,26,31,1,58,367,15.8,7.08
澎湖縣,七美鄉,海豐村,45,22,23,1,46,377,12.2,5.84
澎湖縣,七美鄉,南港村,140,93,47,6,146,1148,12.72,8.1
基隆市,中正區,德義里,306,154,152,3,309,649,47.61,23.73
基隆市,中正區,正義里,546,313,233,5,551,1166,47.26,26.84
基隆市,中正區,信義里,374,187,187,0,374,874,42.79,21.4
基隆市,中正區,義重里,402,217,185,5,407,991,41.07,21.9
基隆市,中正區,港通里,585,296,289,2,587,1177,49.87,25.15
基隆市,中正區,中船里,463,233,230,4,467,1117,41.81,20.86
基隆市,中正區,正船里,535,317,218,5,540,1217,44.37,26.05
基隆市,中正區,入船里,322,189,133,6,328,752,43.62,25.13
基隆市,中正區,中砂里,550,321,229,3,553,1594,34.69,20.14
基隆市,中正區,正砂里,991,602,389,13,1004,2260,44.42,26.64
基隆市,中正區,真砂里,604,339,265,7,611,1294,47.22,26.2
基隆市,中正區,砂灣里,809,498,311,10,819,1981,41.34,25.14
基隆市,中正區,建國里,786,514,272,9,795,1945,40.87,26.43
基隆市,中正區,中濱里,508,278,230,6,514,1245,41.29,22.33
基隆市,中正區,海濱里,394,247,147,2,396,1125,35.2,21.96
基隆市,中正區,社寮里,678,310,368,6,684,1688,40.52,18.36
基隆市,中正區,和憲里,300,183,117,3,303,920,32.93,19.89
基隆市,中正區,平寮里,460,219,241,0,460,1211,37.99,18.08
基隆市,中正區,八斗里,600,174,426,4,604,1442,41.89,12.07
基隆市,中正區,碧砂里,401,157,244,4,405,1212,33.42,12.95
基隆市,中正區,長潭里,204,59,145,2,206,439,46.92,13.44
基隆市,中正區,砂子里,1829,978,851,17,1846,5622,32.84,17.4
基隆市,中正區,中正里,577,303,274,1,578,1615,35.79,18.76
基隆市,中正區,正濱里,359,201,158,2,361,907,39.8,22.16
基隆市,中正區,新豐里,2147,1324,823,17,2164,5731,37.76,23.1
基隆市,中正區,新富里,1614,929,685,17,1631,5124,31.83,18.13
基隆市,七堵區,長興里,1400,796,604,14,1414,3732,37.89,21.33
基隆市,七堵區,正光里,1022,535,487,6,1028,2522,40.76,21.21
基隆市,七堵區,富民里,1457,826,631,18,1475,3476,42.43,23.76
基隆市,七堵區,永平里,833,463,370,5,838,1877,44.65,24.67
基隆市,七堵區,永安里,935,532,403,12,947,2193,43.18,24.26
基隆市,七堵區,八德里,592,303,289,6,598,1482,40.35,20.45
基隆市,七堵區,自強里,471,247,224,8,479,1165,41.12,21.2
基隆市,七堵區,六堵里,832,418,414,8,840,2268,37.04,18.43
基隆市,七堵區,泰安里,1647,913,734,19,1666,4366,38.16,20.91
基隆市,七堵區,堵北里,1381,664,717,15,1396,3616,38.61,18.36
基隆市,七堵區,堵南里,731,353,378,9,740,2070,35.75,17.05
基隆市,七堵區,瑪南里,164,71,93,2,166,402,41.29,17.66
基隆市,七堵區,瑪東里,103,52,51,2,105,317,33.12,16.4
基隆市,七堵區,瑪西里,132,55,77,1,133,325,40.92,16.92
基隆市,七堵區,友一里,915,560,355,6,921,1965,46.87,28.5
基隆市,七堵區,友二里,228,84,144,6,234,448,52.23,18.75
基隆市,七堵區,正明里,811,445,366,10,821,1879,43.69,23.68
基隆市,七堵區,百福里,2130,1074,1056,19,2149,6051,35.51,17.75
基隆市,七堵區,實踐里,1385,695,690,16,1401,3772,37.14,18.43
基隆市,七堵區,長安里,841,451,390,7,848,2505,33.85,18.0
基隆市,暖暖區,八西里,561,308,253,2,563,1390,40.5,22.16
基隆市,暖暖區,八堵里,277,142,135,3,280,641,43.68,22.15
基隆市,暖暖區,八南里,267,131,136,1,268,754,35.54,17.37
基隆市,暖暖區,過港里,1493,884,609,13,1506,3626,41.53,24.38
基隆市,暖暖區,碇內里,1049,606,443,7,1056,2636,40.06,22.99
基隆市,暖暖區,碇和里,1276,855,421,4,1280,2957,43.29,28.91
基隆市,暖暖區,暖同里,1000,577,423,12,1012,2529,40.02,22.82
基隆市,暖暖區,暖暖里,1091,613,478,9,1100,2563,42.92,23.92
基隆市,暖暖區,暖東里,142,71,71,3,145,405,35.8,17.53
基隆市,暖暖區,暖西里,1945,1060,885,14,1959,4724,41.47,22.44
基隆市,暖暖區,八中里,174,89,85,1,175,408,42.89,21.81
基隆市,暖暖區,碇安里,1998,1132,866,18,2016,4877,41.34,23.21
基隆市,暖暖區,碇祥里,2203,1325,878,23,2226,5937,37.49,22.32
基隆市,仁愛區,林泉里,644,353,291,5,649,1698,38.22,20.79
基隆市,仁愛區,花崗里,426,241,185,6,432,1015,42.56,23.74
基隆市,仁愛區,虹橋里,636,353,283,7,643,1481,43.42,23.84
基隆市,仁愛區,水錦里,692,405,287,9,701,1716,40.85,23.6
基隆市,仁愛區,智仁里,910,499,411,8,918,2263,40.57,22.05
基隆市,仁愛區,和明里,685,381,304,9,694,1653,41.98,23.05
基隆市,仁愛區,忠勇里,360,175,185,1,361,924,39.07,18.94
基隆市,仁愛區,玉田里,419,198,221,1,420,945,44.44,20.95
基隆市,仁愛區,仁德里,381,188,193,3,384,840,45.71,22.38
基隆市,仁愛區,博愛里,692,359,333,3,695,1413,49.19,25.41
基隆市,仁愛區,福仁里,330,141,189,6,336,730,46.03,19.32
基隆市,仁愛區,誠仁里,388,180,208,2,390,917,42.53,19.63
基隆市,仁愛區,吉仁里,986,489,497,9,995,2538,39.2,19.27
基隆市,仁愛區,育仁里,275,112,163,4,279,710,39.3,15.77
基隆市,仁愛區,英仁里,474,205,269,4,478,1247,38.33,16.44
基隆市,仁愛區,龍門里,314,136,178,3,317,770,41.17,17.66
基隆市,仁愛區,德厚里,717,397,320,4,721,1698,42.46,23.38
基隆市,仁愛區,曲水里,350,158,192,4,354,790,44.81,20.0
基隆市,仁愛區,崇文里,387,197,190,5,392,846,46.34,23.29
基隆市,仁愛區,文安里,281,127,154,4,285,820,34.76,15.49
基隆市,仁愛區,兆連里,300,172,128,3,303,670,45.22,25.67
基隆市,仁愛區,獅球里,341,189,152,4,345,957,36.05,19.75
基隆市,仁愛區,書院里,374,186,188,5,379,1056,35.89,17.61
基隆市,仁愛區,朝棟里,1138,737,401,23,1161,2712,42.81,27.18
基隆市,仁愛區,明德里,312,164,148,3,315,676,46.6,24.26
基隆市,仁愛區,同風里,247,121,126,1,248,548,45.26,22.08
基隆市,仁愛區,文昌里,365,149,216,4,369,692,53.32,21.53
基隆市,仁愛區,新店里,280,140,140,2,282,571,49.39,24.52
基隆市,仁愛區,光華里,1032,551,481,4,1036,2507,41.32,21.98
基隆市,中山區,新建里,350,190,160,7,357,769,46.42,24.71
基隆市,中山區,安民里,495,248,247,3,498,992,50.2,25.0
基隆市,中山區,安平里,314,151,163,4,318,750,42.4,20.13
基隆市,中山區,中山里,374,159,215,6,380,962,39.5,16.53
基隆市,中山區,民治里,347,198,149,3,350,749,46.73,26.44
基隆市,中山區,中興里,509,290,219,5,514,1221,42.1,23.75
基隆市,中山區,仁正里,308,192,116,2,310,742,41.78,25.88
基隆市,中山區,健民里,493,256,237,7,500,1138,43.94,22.5
基隆市,中山區,通化里,380,229,151,5,385,961,40.06,23.83
基隆市,中山區,居仁里,476,281,195,12,488,1266,38.55,22.2
基隆市,中山區,通明里,686,359,327,8,694,1710,40.58,20.99
基隆市,中山區,協和里,583,315,268,8,591,1512,39.09,20.83
基隆市,中山區,文化里,358,185,173,2,360,1271,28.32,14.56
基隆市,中山區,仙洞里,228,126,102,3,231,563,41.03,22.38
基隆市,中山區,太白里,315,156,159,5,320,864,37.04,18.06
基隆市,中山區,西榮里,273,128,145,7,280,654,42.81,19.57
基隆市,中山區,西華里,405,197,208,4,409,828,49.4,23.79
基隆市,中山區,西定里,343,171,172,3,346,904,38.27,18.92
基隆市,中山區,西康里,566,292,274,12,578,1556,37.15,18.77
基隆市,中山區,德和里,2468,1462,1006,11,2479,5331,46.5,27.42
基隆市,中山區,中和里,2144,1281,863,15,2159,5461,39.53,23.46
基隆市,中山區,德安里,1559,836,723,13,1572,3826,41.09,21.85
基隆市,中山區,和平里,207,141,66,2,209,431,48.49,32.71
基隆市,中山區,和慶里,2193,1195,998,19,2212,6516,33.95,18.34
基隆市,安樂區,西川里,450,247,203,2,452,1179,38.34,20.95
基隆市,安樂區,定國里,403,200,203,4,407,1020,39.9,19.61
基隆市,安樂區,新西里,485,260,225,1,486,1326,36.65,19.61
基隆市,安樂區,定邦里,470,257,213,8,478,998,47.9,25.75
基隆市,安樂區,慈仁里,338,132,206,0,338,883,38.28,14.95
基隆市,安樂區,干城里,702,367,335,5,707,1988,35.56,18.46
基隆市,安樂區,永康里,695,346,349,5,700,1900,36.84,18.21
基隆市,安樂區,嘉仁里,1360,636,724,7,1367,3163,43.22,20.11
基隆市,安樂區,安和里,374,161,213,2,376,821,45.8,19.61
基隆市,安樂區,樂一里,220,103,117,2,222,556,39.93,18.53
基隆市,安樂區,外寮里,1433,812,621,13,1446,3892,37.15,20.86
基隆市,安樂區,中崙里,692,392,300,3,695,1657,41.94,23.66
基隆市,安樂區,內寮里,2050,1160,890,16,2066,5349,38.62,21.69
基隆市,安樂區,新崙里,1502,834,668,15,1517,4007,37.86,20.81
基隆市,安樂區,三民里,1056,568,488,9,1065,2451,43.45,23.17
基隆市,安樂區,四維里,2222,1310,912,17,2239,4656,48.09,28.14
基隆市,安樂區,五福里,1487,882,605,5,1492,3415,43.69,25.83
基隆市,安樂區,六合里,1815,1092,723,14,1829,3876,47.19,28.17
基隆市,安樂區,七賢里,1027,541,486,12,1039,2426,42.83,22.3
基隆市,安樂區,鶯歌里,1036,618,418,7,1043,2796,37.3,22.1
基隆市,安樂區,武崙里,2075,1226,849,15,2090,4808,43.47,25.5
基隆市,安樂區,長樂里,1639,999,640,15,1654,3289,50.29,30.37
基隆市,安樂區,興寮里,1708,979,729,19,1727,4694,36.79,20.86
基隆市,安樂區,鶯安里,2254,1403,851,15,2269,4907,46.24,28.59
基隆市,安樂區,壯觀里,1782,1107,675,10,1792,4239,42.27,26.11
基隆市,信義區,仁壽里,505,290,215,10,515,1024,50.29,28.32
基隆市,信義區,仁義里,596,391,205,6,602,1165,51.67,33.56
基隆市,信義區,義昭里,600,347,253,3,603,1243,48.51,27.92
基隆市,信義區,義幸里,1083,653,430,9,1092,2232,48.92,29.26
基隆市,信義區,義民里,295,159,136,5,300,723,41.49,21.99
基隆市,信義區,義和里,568,337,231,3,571,1508,37.86,22.35
基隆市,信義區,智慧里,347,208,139,10,357,712,50.14,29.21
基隆市,信義區,智誠里,547,276,271,4,551,1483,37.15,18.61
基隆市,信義區,禮儀里,715,413,302,5,720,1552,46.39,26.61
基隆市,信義區,禮東里,706,446,260,7,713,1439,49.55,30.99
基隆市,信義區,信綠里,901,536,365,9,910,1997,45.57,26.84
基隆市,信義區,東光里,786,446,340,5,791,1817,43.53,24.55
基隆市,信義區,東明里,1462,937,525,11,1473,3468,42.47,27.02
基隆市,信義區,東安里,1131,681,450,10,1141,2716,42.01,25.07
基隆市,信義區,孝岡里,481,263,218,4,485,1308,37.08,20.11
基隆市,信義區,東信里,1858,1165,693,18,1876,4064,46.16,28.67
基隆市,信義區,孝深里,1620,951,669,16,1636,4618,35.43,20.59
基隆市,信義區,孝賢里,1541,947,594,12,1553,3461,44.87,27.36
基隆市,信義區,孝德里,963,553,410,6,969,2604,37.21,21.24
基隆市,信義區,孝忠里,2997,1779,1218,8,3005,7553,39.79,23.55
新竹市,東區,南門里,332,134,198,9,341,689,49.49,19.45
新竹市,東區,福德里,655,370,285,2,657,1426,46.07,25.95
新竹市,東區,南市里,363,139,224,7,370,860,43.02,16.16
新竹市,東區,關帝里,211,90,121,6,217,472,45.97,19.07
新竹市,東區,東門里,276,109,167,1,277,527,52.56,20.68
新竹市,東區,成功里,281,121,160,3,284,591,48.05,20.47
新竹市,東區,寺前里,309,148,161,7,316,712,44.38,20.79
新竹市,東區,育賢里,454,254,200,6,460,1657,27.76,15.33
新竹市,東區,中正里,241,114,127,4,245,544,45.04,20.96
新竹市,東區,公園里,1423,827,596,21,1444,3181,45.39,26.0
新竹市,東區,頂竹里,1254,599,655,15,1269,2794,45.42,21.44
新竹市,東區,南大里,631,285,346,6,637,1360,46.84,20.96
新竹市,東區,振興里,2181,1202,979,18,2199,5451,40.34,22.05
新竹市,東區,親仁里,535,310,225,4,539,1058,50.95,29.3
新竹市,東區,文華里,2019,1137,882,29,2048,4446,46.06,25.57
新竹市,東區,復中里,1889,1068,821,25,1914,4120,46.46,25.92
新竹市,東區,三民里,2065,1063,1002,19,2084,4584,45.46,23.19
新竹市,東區,東園里,2650,1402,1248,43,2693,5827,46.22,24.06
新竹市,東區,東勢里,1448,747,701,21,1469,3117,47.13,23.97
新竹市,東區,光復里,1299,659,640,31,1330,2796,47.57,23.57
新竹市,東區,豐功里,2287,1376,911,23,2310,4392,52.6,31.33
新竹市,東區,武功里,2038,1587,451,28,2066,3972,52.01,39.95
新竹市,東區,綠水里,2868,1682,1186,42,2910,6185,47.05,27.19
新竹市,東區,東山里,1539,919,620,25,1564,3075,50.86,29.89
新竹市,東區,光鎮里,1506,792,714,23,1529,3537,43.23,22.39
新竹市,東區,新興里,1326,648,678,30,1356,3009,45.06,21.54
新竹市,東區,柴橋里,2305,1269,1036,27,2332,5175,45.06,24.52
新竹市,東區,高峰里,2443,1307,1136,34,2477,5610,44.15,23.3
新竹市,東區,仙宮里,576,336,240,11,587,1240,47.34,27.1
新竹市,東區,光明里,1458,962,496,22,1480,2932,50.48,32.81
新竹市,東區,立功里,411,308,103,6,417,887,47.01,34.72
新竹市,東區,軍功里,1244,848,396,14,1258,2672,47.08,31.74
新竹市,東區,建功里,1962,1459,503,21,1983,3777,52.5,38.63
新竹市,東區,前溪里,1131,550,581,18,1149,2728,42.12,20.16
新竹市,東區,水源里,1441,681,760,26,1467,3260,45.0,20.89
新竹市,東區,千甲里,869,483,386,23,892,2117,42.14,22.82
新竹市,東區,埔頂里,2625,1305,1320,35,2660,6204,42.88,21.03
新竹市,東區,龍山里,4320,2236,2084,44,4364,9368,46.58,23.87
新竹市,東區,新莊里,2303,1332,971,38,2341,5305,44.13,25.11
新竹市,東區,仙水里,1992,1164,828,20,2012,4355,46.2,26.73
新竹市,東區,金山里,2134,1303,831,27,2161,5215,41.44,24.99
新竹市,東區,關東里,1954,1177,777,25,1979,4835,40.93,24.34
新竹市,東區,科園里,3208,1929,1279,42,3250,6299,51.6,30.62
新竹市,東區,建華里,1054,567,487,20,1074,2356,45.59,24.07
新竹市,東區,新光里,1435,753,682,26,1461,3398,43.0,22.16
新竹市,東區,復興里,2143,1204,939,31,2174,4960,43.83,24.27
新竹市,東區,錦華里,844,493,351,14,858,1881,45.61,26.21
新竹市,東區,湖濱里,1630,898,732,18,1648,3466,47.55,25.91
新竹市,東區,明湖里,1752,1006,746,21,1773,4931,35.96,20.4
新竹市,東區,關新里,1914,965,949,31,1945,3964,49.07,24.34
新竹市,東區,榮光里、親仁里,428,250,178,5,433,958,45.2,26.1
新竹市,東區,下竹里、竹蓮里,532,259,273,7,539,1175,45.87,22.04
新竹市,北區,西門里,252,125,127,3,255,555,45.95,22.52
新竹市,北區,仁德里,317,138,179,4,321,728,44.09,18.96
新竹市,北區,潛園里,329,138,191,7,336,743,45.22,18.57
新竹市,北區,中央里,195,76,119,3,198,464,42.67,16.38
新竹市,北區,崇禮里,471,198,273,7,478,1063,44.97,18.63
新竹市,北區,興南里,527,236,291,9,536,1170,45.81,20.17
新竹市,北區,北門里,442,205,237,3,445,975,45.64,21.03
新竹市,北區,中興里,409,189,220,1,410,867,47.29,21.8
新竹市,北區,大同里,384,221,163,2,386,775,49.81,28.52
新竹市,北區,中山里,381,159,222,2,383,826,46.37,19.25
新竹市,北區,長和里,597,280,317,7,604,1365,44.25,20.51
新竹市,北區,新民里,678,330,348,8,686,1599,42.9,20.64
新竹市,北區,民富里,1895,897,998,24,1919,4837,39.67,18.54
新竹市,北區,水田里,1342,714,628,14,1356,3018,44.93,23.66
新竹市,北區,文雅里,1780,894,886,24,1804,4021,44.86,22.23
新竹市,北區,光田里,956,530,426,9,965,2080,46.39,25.48
新竹市,北區,士林里,787,339,448,15,802,1845,43.47,18.37
新竹市,北區,福林里,1719,1007,712,17,1736,3780,45.93,26.64
新竹市,北區,古賢里,349,143,206,12,361,837,43.13,17.08
新竹市,北區,湳雅里,1283,701,582,20,1303,2741,47.54,25.57
新竹市,北區,舊社里,2627,1492,1135,25,2652,5956,44.53,25.05
新竹市,北區,武陵里,2129,1718,411,29,2158,4508,47.87,38.11
新竹市,北區,南寮里,2011,1047,964,27,2038,5777,35.28,18.12
新竹市,北區,舊港里,223,117,106,4,227,574,39.55,20.38
新竹市,北區,康樂里,1200,596,604,16,1216,2946,41.28,20.23
新竹市,北區,港北里,741,324,417,18,759,1982,38.29,16.35
新竹市,北區,中寮里,1359,705,654,19,1378,3687,37.37,19.12
新竹市,北區,海濱里,1426,733,693,15,1441,4195,34.35,17.47
新竹市,北區,客雅里,701,368,333,5,706,1590,44.4,23.14
新竹市,北區,育英里,1494,708,786,18,1512,3409,44.35,20.77
新竹市,北區,曲溪里,1989,1069,920,21,2010,5102,39.4,20.95
新竹市,北區,西雅里,1191,526,665,27,1218,2825,43.12,18.62
新竹市,北區,南勢里,1492,600,892,28,1520,3409,44.59,17.6
新竹市,北區,境福里,2106,1138,968,32,2138,4668,45.8,24.38
新竹市,北區,磐石里,2313,1145,1168,32,2345,5381,43.58,21.28
新竹市,北區,新雅里,1653,798,855,31,1684,4426,38.05,18.03
新竹市,北區,光華里,1496,827,669,12,1508,4165,36.21,19.86
新竹市,北區,金華里,2170,1165,1005,38,2208,4801,45.99,24.27
新竹市,北區,金竹里,2409,1363,1046,26,2435,5732,42.48,23.78
新竹市,北區,湳中里,2963,1725,1238,39,3002,6577,45.64,26.23
新竹市,北區,金雅里,1314,656,658,22,1336,2938,45.47,22.33
新竹市,北區,台溪里,600,316,284,8,608,1564,38.87,20.2
新竹市,北區,中雅里,1556,1046,510,24,1580,3326,47.5,31.45
新竹市,北區,石坊里、興南里,336,150,186,6,342,684,50.0,21.93
新竹市,北區,南勢里、大鵬里,364,176,188,6,370,995,37.19,17.69
新竹市,香山區,港南里,1042,395,647,16,1058,2715,38.97,14.55
新竹市,香山區,虎山里,2066,933,1133,39,2105,5496,38.3,16.98
新竹市,香山區,虎林里,903,438,465,11,914,2275,40.18,19.25
新竹市,香山區,浸水里,821,336,485,14,835,2355,35.46,14.27
新竹市,香山區,樹下里,907,326,581,14,921,2096,43.94,15.55
新竹市,香山區,埔前里,1305,579,726,19,1324,3186,41.56,18.17
新竹市,香山區,中埔里,1275,658,617,17,1292,2869,45.03,22.93
新竹市,香山區,牛埔里,1717,901,816,24,1741,4595,37.89,19.61
新竹市,香山區,頂埔里,1951,1044,907,30,1981,5017,39.49,20.81
新竹市,香山區,東香里,1806,1054,752,31,1837,4051,45.35,26.02
新竹市,香山區,香村里,1409,791,618,18,1427,3559,40.1,22.23
新竹市,香山區,香山里,1574,776,798,23,1597,4357,36.65,17.81
新竹市,香山區,大庄里,1065,448,617,17,1082,2843,38.06,15.76
新竹市,香山區,美山里,430,162,268,6,436,1121,38.89,14.45
新竹市,香山區,朝山里,771,373,398,11,782,2151,36.36,17.34
新竹市,香山區,海山里,874,461,413,16,890,2366,37.62,19.48
新竹市,香山區,茄苳里,272,152,120,5,277,924,29.98,16.45
新竹市,香山區,大湖里,327,165,162,6,333,862,38.63,19.14
新竹市,香山區,南隘里,299,166,133,4,303,770,39.35,21.56
新竹市,香山區,中隘里,627,362,265,10,637,1828,34.85,19.8
新竹市,香山區,內湖里,1470,737,733,32,1502,4280,35.09,17.22
新竹市,香山區,鹽水里,550,263,287,9,559,1479,37.8,17.78
新竹市,香山區,南港里,336,132,204,5,341,792,43.06,16.67
新竹市,香山區,頂福里,1754,937,817,32,1786,4410,40.5,21.25
嘉義市,東區,荖藤里,1751,726,1025,9,1760,4525,38.9,16.04
嘉義市,東區,後湖里,1362,593,769,11,1373,3379,40.63,17.55
嘉義市,東區,仁義里,1180,556,624,9,1189,2803,42.42,19.84
嘉義市,東區,中庄里,1319,645,674,9,1328,3208,41.4,20.11
嘉義市,東區,頂庄里,901,457,444,7,908,2125,42.73,21.51
嘉義市,東區,圳頭里,1767,974,793,15,1782,4239,42.04,22.98
嘉義市,東區,新店里,1847,929,918,19,1866,4140,45.07,22.44
嘉義市,東區,後庄里,1695,865,830,14,1709,3945,43.32,21.93
嘉義市,東區,王田里,1054,538,516,10,1064,2249,47.31,23.92
嘉義市,東區,東川里,805,430,375,4,809,1740,46.49,24.71
嘉義市,東區,太平里,1782,906,876,10,1792,4209,42.58,21.53
嘉義市,東區,盧厝里,803,369,434,5,808,1933,41.8,19.09
嘉義市,東區,鹿寮里,381,163,218,1,382,1058,36.11,15.41
嘉義市,東區,長竹里,1293,611,682,10,1303,2882,45.21,21.2
嘉義市,東區,短竹里,1083,539,544,6,1089,2346,46.42,22.98
嘉義市,東區,新開里,847,400,447,9,856,1953,43.83,20.48
嘉義市,東區,宣信里,493,196,297,4,497,1241,40.05,15.79
嘉義市,東區,興南里,639,233,406,3,642,1578,40.68,14.77
嘉義市,東區,豐年里,515,214,301,5,520,1231,42.24,17.38
嘉義市,東區,芳草里,1300,560,740,10,1310,3435,38.14,16.3
嘉義市,東區,芳安里,949,420,529,7,956,2160,44.26,19.44
嘉義市,東區,頂寮里,1066,445,621,10,1076,2474,43.49,17.99
嘉義市,東區,安寮里,1126,488,638,11,1137,2693,42.22,18.12
嘉義市,東區,興安里,1161,526,635,11,1172,2905,40.34,18.11
嘉義市,東區,興村里,1528,722,806,8,1536,3865,39.74,18.68
嘉義市,東區,興仁里,1518,729,789,11,1529,3606,42.4,20.22
嘉義市,東區,過溝里,905,376,529,5,910,1993,45.66,18.87
嘉義市,東區,民族里,662,280,382,7,669,1684,39.73,16.63
嘉義市,東區,朝陽里,843,335,508,9,852,1923,44.31,17.42
嘉義市,東區,華南里,800,336,464,10,810,1928,42.01,17.43
嘉義市,東區,東興里,849,355,494,6,855,1797,47.58,19.76
嘉義市,東區,中山里,900,449,451,7,907,1852,48.97,24.24
嘉義市,東區,中央里,994,384,610,7,1001,2130,47.0,18.03
嘉義市,東區,林森里,973,407,566,2,975,2284,42.69,17.82
嘉義市,東區,北門里,952,380,572,12,964,2085,46.24,18.23
嘉義市,東區,蘭潭里,909,448,461,5,914,2195,41.64,20.41
嘉義市,東區,文雅里,1620,844,776,12,1632,3695,44.17,22.84
嘉義市,東區,安業里,779,365,414,4,783,1950,40.15,18.72
嘉義市,東區,義教里,1040,458,582,5,1045,2719,38.43,16.84
嘉義市,西區,香湖里,302,127,175,3,305,819,37.24,15.51
嘉義市,西區,湖邊里,807,297,510,3,810,2045,39.61,14.52
嘉義市,西區,北榮里,1022,378,644,9,1031,2205,46.76,17.14
嘉義市,西區,重興里,764,297,467,11,775,1945,39.85,15.27
嘉義市,西區,竹圍里,1735,713,1022,19,1754,4451,39.41,16.02
嘉義市,西區,新厝里,1742,599,1143,16,1758,4153,42.33,14.42
嘉義市,西區,保安里,1299,541,758,12,1311,3225,40.65,16.78
嘉義市,西區,北湖里,1175,456,719,6,1181,2954,39.98,15.44
嘉義市,西區,下埤里,593,232,361,7,600,1556,38.56,14.91
嘉義市,西區,竹村里,428,182,246,5,433,1125,38.49,16.18
嘉義市,西區,大溪里,819,291,528,5,824,2143,38.45,13.58
嘉義市,西區,福全里,1615,698,917,18,1633,4114,39.69,16.97
嘉義市,西區,西平里,1339,539,800,13,1352,3239,41.74,16.64
嘉義市,西區,磚磘里,1388,548,840,16,1404,3497,40.15,15.67
嘉義市,西區,港坪里,1355,614,741,10,1365,3363,40.59,18.26
嘉義市,西區,頭港里,755,302,453,4,759,1847,41.09,16.35
嘉義市,西區,劉厝里,2651,1228,1423,22,2673,6843,39.06,17.95
嘉義市,西區,新西里,793,323,470,10,803,2010,39.95,16.07
嘉義市,西區,書院里,866,384,482,12,878,1889,46.48,20.33
嘉義市,西區,培元里,774,446,328,2,776,1615,48.05,27.62
嘉義市,西區,垂楊里,678,279,399,13,691,1915,36.08,14.57
嘉義市,西區,車店里,2344,1013,1331,13,2357,5748,41.01,17.62
嘉義市,西區,福民里,2120,947,1173,16,2136,5437,39.29,17.42
嘉義市,西區,湖內里,1765,669,1096,9,1774,4510,39.33,14.83
嘉義市,西區,美源里,1530,656,874,11,1541,3560,43.29,18.43
嘉義市,西區,育英里,775,306,469,5,780,1726,45.19,17.73
嘉義市,西區,致遠里,810,608,202,13,823,1739,47.33,34.96
嘉義市,西區,光路里,2155,976,1179,26,2181,5111,42.67,19.1
嘉義市,西區,翠岱里,653,496,157,4,657,1383,47.51,35.86
嘉義市,西區,自強里,698,313,385,5,703,1622,43.34,19.3
嘉義市,西區,永和里,777,324,453,4,781,1864,41.9,17.38
嘉義市,西區,新富里,732,238,494,7,739,1627,45.42,14.63
嘉義市,西區,文化里,1025,399,626,7,1032,2211,46.68,18.05
嘉義市,西區,西榮里,1005,371,634,6,1011,2209,45.77,16.79
嘉義市,西區,國華里,549,236,313,2,551,1253,43.97,18.83
嘉義市,西區,番社里,636,241,395,9,645,1355,47.6,17.79
嘉義市,西區,導明里,685,276,409,9,694,1512,45.9,18.25
嘉義市,西區,慶安里,633,235,398,8,641,1521,42.14,15.45
嘉義市,西區,後驛里,806,290,516,5,811,2042,39.72,14.2
嘉義市,西區,福安里,1700,707,993,17,1717,4195,40.93,16.85
嘉義市,西區,獅子里,1135,498,637,14,1149,2686,42.78,18.54
嘉義市,西區,紅瓦里,647,232,415,4,651,1570,41.46,14.78
嘉義市,西區,保福里,1365,593,772,6,1371,3637,37.7,16.3
嘉義市,西區,保生里,1837,742,1095,9,1846,4295,42.98,17.28
嘉義市,西區,北新里,508,190,318,3,511,1115,45.83,17.04
金門縣,金城鎮,東門里,959,859,100,7,966,4809,20.09,17.86
金門縣,金城鎮,西門里,2028,1824,204,12,2040,9671,21.09,18.86
金門縣,金城鎮,南門里,1071,947,124,9,1080,5344,20.21,17.72
金門縣,金城鎮,北門里,726,644,82,7,733,3979,18.42,16.18
金門縣,金城鎮,古城里,729,620,109,8,737,4023,18.32,15.41
金門縣,金城鎮,金水里,456,397,59,6,462,2226,20.75,17.83
金門縣,金城鎮,珠沙里,501,439,62,5,506,2885,17.54,15.22
金門縣,金城鎮,賢庵里,845,724,121,6,851,4730,17.99,15.31
金門縣,金沙鎮,汶沙里,966,876,90,13,979,5076,19.29,17.26
金門縣,金沙鎮,三山里,337,298,39,6,343,1955,17.54,15.24
金門縣,金沙鎮,大洋里,216,200,16,4,220,1153,19.08,17.35
金門縣,金沙鎮,光前里,438,382,56,3,441,2348,18.78,16.27
金門縣,金沙鎮,何斗里,381,352,29,2,383,2045,18.73,17.21
金門縣,金沙鎮,西園里,263,243,20,2,265,1592,16.65,15.26
金門縣,金沙鎮,官嶼里,366,338,28,6,372,2210,16.83,15.29
金門縣,金沙鎮,浦山里,447,407,40,6,453,2345,19.32,17.36
金門縣,金湖鎮,新市里,842,751,91,12,854,3969,21.52,18.92
金門縣,金湖鎮,山外里,658,577,81,12,670,3328,20.13,17.34
金門縣,金湖鎮,正義里,513,454,59,13,526,2699,19.49,16.82
金門縣,金湖鎮,料羅里,422,357,65,7,429,2132,20.12,16.74
金門縣,金湖鎮,瓊林里,653,579,74,10,663,3259,20.34,17.77
金門縣,金湖鎮,新湖里,1534,1290,244,14,1548,8073,19.18,15.98
金門縣,金湖鎮,溪湖里,237,225,12,5,242,1560,15.51,14.42
金門縣,金湖鎮,蓮庵里,352,318,34,6,358,1704,21.01,18.66
金門縣,金寧鄉,古寧村,478,416,62,5,483,3363,14.36,12.37
金門縣,金寧鄉,安美村,823,694,129,15,838,5049,16.6,13.75
金門縣,金寧鄉,后盤村,303,270,33,2,305,1618,18.85,16.69
金門縣,金寧鄉,湖埔村,1520,1225,295,15,1535,7551,20.33,16.22
金門縣,金寧鄉,榜林村,927,809,118,12,939,5268,17.82,15.36
金門縣,金寧鄉,盤山村,1274,1004,270,19,1293,6403,20.19,15.68
金門縣,烈嶼鄉,上岐村,456,410,46,9,465,2843,16.36,14.42
金門縣,烈嶼鄉,上林村,183,167,16,7,190,1428,13.31,11.69
金門縣,烈嶼鄉,西口村,341,297,44,10,351,2415,14.53,12.3
金門縣,烈嶼鄉,林湖村,611,558,53,5,616,3328,18.51,16.77
金門縣,烈嶼鄉,黃埔村,228,208,20,4,232,1642,14.13,12.67
金門縣,烏坵鄉,大坵村,19,14,5,0,19,270,7.04,5.19
金門縣,烏坵鄉,小坵村,18,14,4,0,18,299,6.02,4.68
連江縣,南竿鄉,介壽村,646,564,82,6,652,1982,32.9,28.46
連江縣,南竿鄉,復興村、福沃村,467,404,63,6,473,1682,28.12,24.02
連江縣,南竿鄉,清水村、珠螺村,329,270,59,5,334,1223,27.31,22.08
連江縣,南竿鄉,仁愛村、津沙村、馬祖村、四維村,438,395,43,3,441,1618,27.26,24.41
連江縣,北竿鄉,塘岐村、后沃村,329,282,47,6,335,1310,25.57,21.53
連江縣,北竿鄉,橋仔村、芹壁村、坂里村、白沙村,285,245,40,4,289,1227,23.55,19.97
連江縣,莒光鄉,青帆村、田沃村、西坵村,157,137,20,1,158,668,23.65,20.51
連江縣,莒光鄉,福正村、大坪村,139,124,15,2,141,695,20.29,17.84
連江縣,東引鄉,中柳村、樂華村,295,265,30,0,295,1268,23.26,20.9
